Customer ID,max_order_date,recency,frequency,Monetary,r_score,f_score,m_score,rfm,rfm_score
AA-10315,2014-12-23,8,19,447.6904999999998,9,6,5,20,7
AA-10375,2014-12-25,6,23,677.4773999999999,9,7,6,22,8
AA-10480,2014-09-05,117,20,1516.4751799999995,3,6,8,17,5
AA-10645,2014-12-05,26,36,3051.438999999999,7,10,10,27,10
AA-315,2014-12-29,2,7,535.5659999999999,10,3,5,18,6
AA-375,2014-07-03,181,8,77.44199999999998,2,4,3,9,2
AA-480,2014-02-20,314,5,554.6129999999999,1,2,5,8,2
AA-645,2014-10-11,81,11,-608.346,4,5,1,10,3
AB-10015,2014-12-15,16,32,3719.488000000001,8,10,10,28,10
AB-10060,2014-12-06,25,32,4514.058899999999,7,10,10,27,10
AB-10105,2014-11-29,32,33,6912.6145,6,10,10,26,9
AB-10150,2014-12-09,22,24,2064.2143000000005,7,7,9,23,8
AB-10165,2014-12-18,13,29,2329.4699999999993,8,9,9,26,9
AB-10255,2014-12-26,5,31,-43.23810000000014,10,10,2,22,8
AB-105,2014-11-18,43,7,-495.32999999999987,5,3,1,9,2
AB-10600,2014-11-11,50,22,905.3606999999998,5,6,6,17,5
AB-15,2013-11-14,412,5,963.7199999999999,1,2,7,10,3
AB-150,2013-11-28,398,4,862.1400000000001,1,1,6,8,2
AB-165,2014-12-15,16,6,106.59599999999998,8,2,3,13,4
AB-255,2014-11-18,43,8,801.852,5,4,6,15,5
AB-60,2014-11-26,35,9,465.91799999999995,6,5,5,16,5
AB-600,2014-12-24,7,5,964.6499999999996,9,2,7,18,6
AC-10420,2014-12-25,6,24,206.4804999999998,9,7,4,20,7
AC-10450,2014-12-26,5,19,4105.604200000001,10,6,10,26,9
AC-10615,2014-12-25,6,29,1160.6757799999996,9,9,7,25,9
AC-10660,2014-12-29,2,21,-998.9973200000003,10,6,1,17,5
AC-420,2014-12-18,13,9,237.55499999999998,8,5,4,17,5
AC-450,2014-09-06,116,7,-125.19300000000007,3,3,2,8,2
AC-615,2014-09-30,92,7,-280.548,3,3,1,7,1
AC-660,2014-03-09,297,4,726.8700000000001,1,1,6,8,2
AD-10180,2014-12-05,26,27,2050.7542,7,8,9,24,9
AD-180,2014-12-26,5,3,-510.76200000000006,10,1,1,12,4
AF-10870,2014-12-25,6,36,1736.0716999999995,9,10,8,27,10
AF-10885,2014-10-16,76,35,2882.914779999999,4,10,10,24,9
AF-870,2014-12-26,5,9,542.232,10,5,5,20,7
AF-885,2014-11-06,55,2,88.32000000000001,5,1,3,9,2
AG-10270,2014-11-21,40,25,2151.996119999999,6,7,9,22,8
AG-10300,2014-12-29,2,24,1845.7665999999995,10,7,8,25,9
AG-10330,2014-12-23,8,29,929.4670800000002,9,9,6,24,9
AG-10390,2014-08-09,144,19,995.7429999999999,2,6,7,15,5
AG-10495,2014-10-14,78,29,2749.061859999999,4,9,10,23,8
AG-10525,2014-12-19,12,20,36.03370000000001,8,6,3,17,5
AG-10675,2014-11-14,47,21,680.7906999999999,5,6,6,17,5
AG-10765,2014-11-06,55,27,1250.5845,5,8,7,20,7
AG-10900,2014-09-26,96,29,1879.76716,3,9,9,21,7
AG-270,2014-12-18,13,8,450.576,8,4,5,17,5
AG-300,2014-09-24,98,6,-1072.62,3,2,1,6,1
AG-330,2014-12-29,2,7,77.50500000000002,10,3,3,16,5
AG-390,2014-10-09,83,4,-548.478,4,1,1,6,1
AG-495,2014-12-09,22,11,-106.84799999999998,7,5,2,14,4
AG-525,2014-12-16,15,7,133.35599999999997,8,3,3,14,4
AG-675,2014-11-07,54,10,242.27100000000013,5,5,4,14,4
AG-765,2014-08-09,144,8,-1075.278,2,4,1,7,1
AG-900,2014-08-12,141,4,-146.52000000000004,2,1,2,5,1
AH-10030,2014-12-19,12,27,2601.4330400000003,8,8,10,26,9
AH-10075,2014-12-29,2,34,986.0434199999997,10,10,7,27,10
AH-10120,2014-09-09,113,22,1705.13728,3,6,8,17,5
AH-10195,2014-12-11,20,25,158.90887999999998,7,7,3,17,5
AH-10210,2014-12-25,6,34,4139.660779999998,9,10,10,29,10
AH-10465,2014-10-22,70,20,611.8889800000002,4,6,6,16,5
AH-10585,2014-10-12,80,22,1458.3500999999994,4,6,8,18,6
AH-10690,2014-10-02,90,31,2795.843720000001,3,10,10,23,8
AH-120,2014-10-12,80,4,376.24199999999996,4,1,5,10,3
AH-195,2014-09-02,120,9,-751.155,3,5,1,9,2
AH-210,2013-09-30,457,4,202.71,1,1,4,6,1
AH-30,2013-09-19,468,7,-150.50400000000002,1,3,2,6,1
AH-465,2014-04-05,270,4,106.446,1,1,3,5,1
AH-585,2014-10-17,75,9,151.722,4,5,3,12,4
AH-690,2014-03-11,295,5,-329.83200000000005,1,2,1,4,1
AH-75,2014-11-24,37,8,915.99,6,4,6,16,5
AI-10855,2014-12-18,13,22,1612.7634,8,6,8,22,8
AI-855,2014-11-06,55,4,-74.58599999999997,5,1,2,8,2
AJ-10780,2014-11-13,48,25,1784.2461999999998,5,7,8,20,7
AJ-10795,2014-10-30,62,22,1861.0923999999993,4,6,9,19,6
AJ-10945,2014-10-13,79,29,1567.6391999999996,4,9,8,21,7
AJ-10960,2014-11-13,48,17,1518.6719799999996,5,6,8,19,6
AJ-780,2014-12-30,1,12,-612.0060000000001,10,5,1,16,5
AJ-795,2014-11-25,36,10,617.4900000000001,6,5,6,17,5
AJ-945,2014-09-18,104,7,1439.0639999999994,3,3,8,14,4
AJ-960,2014-12-03,28,10,1012.686,6,5,7,18,6
AM-10360,2014-12-16,15,33,2748.4754000000003,8,10,10,28,10
AM-10705,2014-12-02,29,30,2728.645100000001,6,9,10,25,9
AM-360,2014-09-07,115,6,229.37700000000004,3,2,4,9,2
AM-705,2014-08-17,136,6,509.94000000000005,2,2,5,9,2
AO-10810,2014-11-25,36,27,1028.3926000000001,6,8,7,21,7
AO-810,2014-12-24,7,5,64.707,9,2,3,14,4
AP-10720,2014-11-20,41,20,2937.4660999999996,5,6,10,21,7
AP-10915,2014-11-09,52,32,2420.1055999999985,5,10,9,24,9
AP-720,2014-11-24,37,6,55.29900000000002,6,2,3,11,3
AP-915,2014-09-30,92,5,717.5099999999999,3,2,6,11,3
AR-10345,2014-11-09,52,26,1683.9278000000002,5,8,8,21,7
AR-10405,2014-11-09,52,22,-583.4818200000001,5,6,1,12,4
AR-10510,2014-12-17,14,29,3518.9608599999997,8,9,10,27,10
AR-10540,2014-12-25,6,15,3050.9133,9,6,10,25,9
AR-10570,2014-12-29,2,18,1584.8323200000002,10,6,8,24,9
AR-10825,2014-10-13,79,38,2828.1048,4,10,10,24,9
AR-345,2014-12-08,23,9,606.732,7,5,6,18,6
AR-405,2014-05-23,222,6,31.200000000000014,2,2,3,7,1
AR-510,2014-12-04,27,10,42.798,7,5,3,15,5
AR-540,2014-06-01,213,8,88.17,2,4,3,9,2
AR-570,2014-12-03,28,9,409.8179999999999,6,5,5,16,5
AR-825,2014-11-28,33,7,289.54199999999986,6,3,4,13,4
AS-10045,2014-10-16,76,28,660.9177999999998,4,9,6,19,6
AS-10090,2014-12-16,15,32,1344.9601199999993,8,10,7,25,9
AS-10135,2014-11-20,41,19,750.2937999999998,5,6,6,17,5
AS-10225,2014-12-19,12,28,2718.6598000000004,8,9,10,27,10
AS-10240,2014-12-19,12,31,630.3841600000001,8,10,6,24,9
AS-10285,2014-12-13,18,30,1794.8640599999997,8,9,8,25,9
AS-10630,2014-11-26,35,19,3194.363400000001,6,6,10,22,8
AS-135,2014-09-30,92,5,814.2000000000002,3,2,6,11,3
AS-225,2014-12-29,2,7,-215.02499999999998,10,3,2,15,5
AS-240,2013-08-20,498,5,545.0699999999999,1,2,5,8,2
AS-285,2014-09-23,99,13,738.702,3,5,6,14,4
AS-45,2014-12-05,26,3,-291.756,7,1,1,9,2
AS-630,2014-11-28,33,11,-1103.3100000000004,6,5,1,12,4
AS-90,2014-10-12,80,4,76.31400000000002,4,1,3,8,2
AT-10435,2014-12-19,12,24,3016.898299999999,8,7,10,25,9
AT-10735,2014-12-29,2,29,2516.7079000000003,10,9,9,28,10
AT-435,2014-11-02,59,12,-221.36700000000002,4,5,2,11,3
AT-735,2014-10-23,69,5,143.07,4,2,3,9,2
AW-10840,2014-12-15,16,25,1444.8320200000005,8,7,8,23,8
AW-10930,2014-11-26,35,22,2585.881959999999,6,6,9,21,7
AW-840,2014-09-25,97,7,-228.42000000000002,3,3,2,8,2
AW-930,2014-11-24,37,6,95.08500000000001,6,2,3,11,3
AY-10555,2014-12-17,14,16,1850.5163400000006,8,6,9,23,8
AY-555,2014-11-26,35,11,440.4599999999999,6,5,5,16,5
AZ-10750,2014-11-09,52,18,1606.5633,5,6,8,19,6
AZ-750,2014-11-06,55,10,-682.2030000000001,5,5,1,11,3
BB-10990,2014-12-17,14,30,177.06659999999997,8,9,4,21,7
BB-11545,2014-12-11,20,26,1686.6588800000002,7,8,8,23,8
BB-1545,2014-12-11,20,5,52.187999999999995,7,2,3,12,4
BB-990,2014-11-11,50,7,122.35799999999999,5,3,3,11,3
BC-11125,2014-12-06,25,28,2755.678400000001,7,9,10,26,9
BC-1125,2014-08-22,131,6,-269.718,2,2,1,5,1
BD-11320,2014-12-26,5,32,1409.6197000000002,10,10,7,27,10
BD-11500,2014-12-12,19,27,2412.359,7,8,9,24,9
BD-11560,2014-12-24,7,19,1909.8637399999998,9,6,9,24,9
BD-11605,2014-09-25,97,19,1201.1774399999995,3,6,7,16,5
BD-11620,2014-12-11,20,25,448.50692000000004,7,7,5,19,6
BD-11635,2014-12-22,9,25,1303.6163000000006,9,7,7,23,8
BD-11725,2014-12-27,4,30,1574.1360999999993,10,9,8,27,10
BD-11770,2014-11-26,35,26,2397.81426,6,8,9,23,8
BD-1320,2014-12-26,5,6,213.05999999999995,10,2,4,16,5
BD-1500,2013-11-28,398,3,-31.293000000000006,1,1,2,4,1
BD-1560,2014-06-27,187,5,114.83999999999999,2,2,3,7,1
BD-1605,2014-03-31,275,5,224.48999999999998,1,2,4,7,1
BD-1620,2014-09-08,114,11,535.917,3,5,5,13,4
BD-1635,2014-10-02,90,9,1488.693,3,5,8,16,5
BD-1725,2014-09-22,100,13,901.0200000000001,3,5,6,14,4
BD-1770,2014-07-05,179,5,-869.5439999999999,2,2,1,5,1
BE-11335,2014-11-26,35,37,7790.696300000003,6,10,10,26,9
BE-11410,2014-09-24,98,30,3398.09706,3,9,10,22,8
BE-11455,2014-12-28,3,27,517.9141000000001,10,8,5,23,8
BE-1335,2013-07-06,543,5,-380.69100000000003,1,2,1,4,1
BE-1410,2014-10-28,64,7,391.05899999999997,4,3,5,12,4
BE-1455,2014-07-08,176,2,460.11,2,1,5,8,2
BF-1005,2012-12-27,734,2,176.433,1,1,4,6,1
BF-1020,2014-09-26,96,7,-193.13400000000007,3,3,2,8,2
BF-1080,2014-05-06,239,6,896.9399999999998,1,2,6,9,2
BF-10975,2014-11-26,35,22,1217.0095999999996,6,6,7,19,6
BF-11005,2014-12-23,8,25,939.23756,9,7,6,22,8
BF-11020,2014-12-16,15,24,1133.2552999999998,8,7,7,22,8
BF-11080,2014-10-20,72,21,1187.5689000000002,4,6,7,17,5
BF-11170,2014-12-15,16,31,3859.22114,8,10,10,28,10
BF-11215,2014-10-27,65,27,878.9098000000002,4,8,6,18,6
BF-11275,2014-12-25,6,23,565.0688399999999,9,7,5,21,7
BF-1170,2014-06-21,193,6,275.88000000000005,2,2,4,8,2
BF-1215,2014-05-09,236,5,-237.59099999999992,1,2,1,4,1
BF-1275,2014-12-07,24,7,96.38400000000001,7,3,3,13,4
BF-975,2014-09-12,110,8,616.722,3,4,6,13,4
BG-1035,2013-10-05,452,1,-219.804,1,1,2,4,1
BG-11035,2014-08-18,135,33,1749.982,2,10,8,20,7
BG-11695,2014-12-22,9,19,568.96988,9,6,5,20,7
BG-11740,2014-12-25,6,24,2084.9244,9,7,9,25,9
BG-1695,2014-11-17,44,5,-151.65000000000003,5,2,2,9,2
BG-1740,2014-12-15,16,4,-658.2959999999999,8,1,1,10,3
BH-11710,2014-10-27,65,31,3243.943800000001,4,10,10,24,9
BH-1710,2014-09-29,93,10,1632.996,3,5,8,16,5
BK-11260,2014-11-14,47,27,2389.4549599999996,5,8,9,22,8
BK-1260,2014-11-21,40,6,58.224,6,2,3,11,3
BM-11140,2014-12-23,8,29,-1140.6354000000003,9,9,1,19,6
BM-1140,2014-12-18,13,6,43.71000000000001,8,2,3,13,4
BM-11575,2014-11-27,34,25,-189.53731999999988,6,7,2,15,5
BM-11650,2014-12-06,25,24,3927.16918,7,7,10,24,9
BM-11785,2014-12-29,2,36,2036.684799999999,10,10,9,29,10
BM-1575,2014-11-21,40,9,471.6720000000001,6,5,5,16,5
BM-1650,2013-06-09,570,8,458.67600000000004,1,4,5,10,3
BM-1785,2014-11-13,48,9,475.932,5,5,5,15,5
BN-11470,2014-12-20,11,29,1548.0409799999998,9,9,8,26,9
BN-11515,2014-12-22,9,23,2018.6969199999996,9,7,9,25,9
BN-1470,2014-10-11,81,7,576.0120000000001,4,3,5,12,4
BN-1515,2014-09-23,99,8,525.3720000000001,3,4,5,12,4
BO-11350,2014-11-09,52,20,555.1937,5,6,5,16,5
BO-11425,2014-12-26,5,21,1904.8977199999997,10,6,9,25,9
BO-1350,2014-10-12,80,6,-139.974,4,2,2,8,2
BO-1425,2014-12-30,1,8,651.9269999999999,10,4,6,20,7
BP-1050,2014-12-20,11,9,1245.8820000000005,9,5,7,21,7
BP-1095,2014-12-20,11,6,384.828,9,2,5,16,5
BP-11050,2014-12-26,5,21,845.0797599999999,10,6,6,22,8
BP-11095,2014-12-29,2,32,599.4306999999999,10,10,6,26,9
BP-11155,2014-12-11,20,24,3395.3071599999994,7,7,10,24,9
BP-11185,2014-12-30,1,28,1989.4898200000002,10,9,9,28,10
BP-11230,2014-11-22,39,23,467.9241000000001,6,7,5,18,6
BP-11290,2014-12-19,12,29,1858.8290800000002,8,9,9,26,9
BP-1155,2014-04-14,261,6,180.9,1,2,4,7,1
BP-1185,2014-12-27,4,10,-645.5340000000002,10,5,1,16,5
BP-1230,2014-09-10,112,8,444.28799999999984,3,4,5,12,4
BP-1290,2013-12-27,369,4,99.27000000000001,1,1,3,5,1
BS-11365,2014-12-31,0,26,5680.727359999998,10,8,10,28,10
BS-11380,2014-11-17,44,23,1776.7021000000009,5,7,8,20,7
BS-11590,2014-11-26,35,23,1783.4587200000005,6,7,8,21,7
BS-11665,2014-11-25,36,24,3112.157799999999,6,7,10,23,8
BS-11755,2014-12-30,1,29,1194.7291000000002,10,9,7,26,9
BS-11800,2014-12-22,9,21,1851.8634000000009,9,6,9,24,9
BS-1365,2014-12-05,26,5,288.18,7,2,4,13,4
BS-1380,2014-08-22,131,5,38.328,2,2,3,7,1
BS-1590,2014-08-05,148,5,262.22999999999996,2,2,4,8,2
BS-1665,2014-01-08,357,7,500.718,1,3,5,9,2
BS-1755,2014-11-03,58,5,-697.7700000000001,4,2,1,7,1
BS-1800,2014-12-20,11,9,931.3439999999999,9,5,6,20,7
BT-11305,2014-09-29,93,24,908.1758,3,7,6,16,5
BT-11395,2014-12-03,28,24,2743.962300000001,6,7,10,23,8
BT-11440,2014-11-05,56,21,290.9338999999999,4,6,4,14,4
BT-11485,2014-10-14,78,29,1170.7539399999998,4,9,7,20,7
BT-11530,2014-11-28,33,25,930.8343000000001,6,7,6,19,6
BT-11680,2014-12-13,18,22,1663.9095,8,6,8,22,8
BT-1305,2014-12-08,23,10,-44.24999999999999,7,5,2,14,4
BT-1395,2014-11-28,33,4,-199.032,6,1,2,9,2
BT-1440,2014-09-29,93,10,-760.7250000000001,3,5,1,9,2
BT-1485,2014-09-25,97,9,-231.12599999999995,3,5,2,10,3
BT-1530,2014-01-13,352,7,522.8009999999999,1,3,5,9,2
BT-1680,2014-04-11,264,4,131.64000000000001,1,1,3,5,1
BV-11245,2014-11-17,44,22,3415.0463999999984,5,6,10,21,7
BV-1245,2014-08-25,128,3,-595.296,3,1,1,5,1
BW-1065,2014-09-12,110,5,3341.34,3,2,10,15,5
BW-11065,2014-11-11,50,18,354.06329999999997,5,6,5,16,5
BW-1110,2014-06-30,184,10,258.41999999999996,2,5,4,11,3
BW-11110,2014-11-02,59,35,3337.4658999999997,4,10,10,24,9
BW-11200,2014-11-21,40,29,1567.8803800000003,6,9,8,23,8
BW-1200,2014-08-20,133,4,784.326,2,1,6,9,2
CA-11965,2014-12-13,18,26,3382.2602999999986,8,8,10,26,9
CA-12055,2014-12-18,13,22,1738.3698999999997,8,6,8,22,8
CA-12265,2014-11-27,34,31,3270.7200000000003,6,10,10,26,9
CA-12310,2014-12-18,13,21,727.9286600000001,8,6,6,20,7
CA-12775,2014-09-29,93,26,4605.477500000001,3,8,10,21,7
CA-1965,2014-08-26,127,8,-103.17900000000004,3,4,2,9,2
CA-2055,2014-04-17,258,3,131.39999999999998,1,1,3,5,1
CA-2265,2014-09-17,105,7,391.398,3,3,5,11,3
CA-2310,2014-01-29,336,5,139.23,1,2,3,6,1
CA-2775,2014-02-25,309,4,-714.213,1,1,1,3,1
CB-12025,2014-12-22,9,25,-98.73150000000001,9,7,2,18,6
CB-12415,2014-11-25,36,23,2271.8956600000006,6,7,9,22,8
CB-12535,2014-11-19,42,27,2401.9074399999995,5,8,9,22,8
CB-2025,2014-09-12,110,5,307.5600000000001,3,2,4,9,2
CB-2415,2013-02-08,691,4,-184.81199999999995,1,1,2,4,1
CB-2535,2014-12-24,7,2,-234.69,9,1,1,11,3
CC-12100,2014-10-11,81,25,2384.2594400000016,4,7,9,20,7
CC-12145,2014-12-02,29,24,1471.929099999999,6,7,8,21,7
CC-12220,2014-11-17,44,32,1315.8066,5,10,7,22,8
CC-12370,2014-11-18,43,30,3982.928700000001,5,9,10,24,9
CC-12430,2014-12-31,0,29,2779.9208599999993,10,9,10,29,10
CC-12475,2014-12-15,16,30,3120.1634599999998,8,9,10,27,10
CC-12550,2014-11-02,59,25,1167.4589399999998,4,7,7,18,6
CC-12610,2014-12-15,16,29,2950.1929999999993,8,9,10,27,10
CC-12670,2014-12-15,16,28,-549.5837000000001,8,9,1,18,6
CC-12685,2014-12-08,23,20,693.6282999999996,7,6,6,19,6
CC-2100,2014-08-08,145,5,238.36799999999997,2,2,4,8,2
CC-2145,2013-08-14,504,6,-164.13,1,2,2,5,1
CC-2220,2014-12-09,22,12,1190.082,7,5,7,19,6
CC-2370,2014-12-25,6,9,1620.4050000000002,9,5,8,22,8
CC-2430,2013-09-16,471,2,160.59,1,1,4,6,1
CC-2475,2014-06-11,203,7,914.6909999999999,2,3,6,11,3
CC-2550,2014-04-04,271,5,357.09,1,2,5,8,2
CC-2610,2014-01-21,344,3,52.818,1,1,3,5,1
CC-2670,2014-07-08,176,6,268.6020000000001,2,2,4,8,2
CC-2685,2014-08-22,131,5,1556.2319999999995,2,2,8,12,4
CD-11920,2014-12-29,2,27,4751.7303999999995,10,8,10,28,10
CD-11980,2014-12-30,1,23,1648.4392599999999,10,7,8,25,9
CD-12280,2014-12-07,24,24,2367.3817799999997,7,7,9,23,8
CD-12790,2014-11-08,53,25,2080.484700000001,5,7,9,21,7
CD-1920,2014-02-20,314,4,277.179,1,1,4,6,1
CD-1980,2014-12-25,6,7,231.918,9,3,4,16,5
CD-2280,2014-12-19,12,7,224.39999999999995,8,3,4,15,5
CD-2790,2014-08-22,131,7,73.818,2,3,3,8,2
CG-12040,2014-12-11,20,19,149.07060000000007,7,6,3,16,5
CG-12520,2014-11-11,50,18,2398.1344199999994,5,6,9,20,7
CG-2040,2013-12-18,378,5,-395.90999999999997,1,2,1,4,1
CG-2520,2014-05-30,215,7,168.444,2,3,4,9,2
CH-12070,2014-12-08,23,21,1493.42166,7,6,8,21,7
CH-2070,2014-02-28,306,8,1178.0879999999995,1,4,7,12,4
CJ-11875,2014-12-18,13,23,1857.2449599999993,8,7,9,24,9
CJ-12010,2014-12-02,29,26,2386.722000000001,6,8,9,23,8
CJ-1875,2014-11-29,32,6,100.18199999999999,6,2,3,11,3
CJ-2010,2014-11-15,46,3,30.87,5,1,3,9,2
CK-12205,2014-12-27,4,38,1311.2059400000003,10,10,7,27,10
CK-12325,2014-10-31,61,27,849.5182199999997,4,8,6,18,6
CK-12595,2014-11-18,43,33,2175.845980000001,5,10,9,24,9
CK-12760,2014-11-06,55,26,-100.50569999999998,5,8,2,15,5
CK-2205,2014-10-13,79,5,-345.393,4,2,1,7,1
CK-2325,2014-12-31,0,8,531.195,10,4,5,19,6
CK-2595,2014-05-30,215,3,197.79,2,1,4,7,1
CK-2760,2014-11-24,37,12,625.8900000000001,6,5,6,17,5
CL-11890,2014-12-18,13,31,-247.7379400000001,8,10,1,19,6
CL-12565,2014-12-26,5,30,614.5829799999995,10,9,6,25,9
CL-12700,2014-12-23,8,31,2563.4446999999986,9,10,9,28,10
CL-1890,2014-09-30,92,9,83.47500000000001,3,5,3,11,3
CL-2565,2014-11-19,42,6,708.846,5,2,6,13,4
CL-2700,2014-12-08,23,4,106.88400000000001,7,1,3,11,3
CM-11815,2014-11-21,40,23,-2881.6446000000005,6,7,1,14,4
CM-11830,2014-12-25,6,24,2444.6990000000005,9,7,9,25,9
CM-11935,2014-11-25,36,18,2081.0879999999993,6,6,9,21,7
CM-12115,2014-12-23,8,20,2164.8172000000004,9,6,9,24,9
CM-12160,2014-10-22,70,26,432.55681999999985,4,8,5,17,5
CM-12190,2014-12-31,0,25,598.4815199999999,10,7,6,23,8
CM-12235,2014-11-19,42,22,1953.9977000000003,5,6,9,20,7
CM-12385,2014-11-24,37,25,3029.960319999999,6,7,10,23,8
CM-12445,2014-12-16,15,25,1188.12768,8,7,7,22,8
CM-12655,2014-07-02,182,18,-733.9564199999999,2,6,1,9,2
CM-12715,2014-12-05,26,19,915.3872999999999,7,6,6,19,6
CM-1815,2014-10-31,61,5,82.854,4,2,3,9,2
CM-1830,2014-09-09,113,13,39.98699999999999,3,5,3,11,3
CM-1935,2014-11-13,48,7,125.27399999999997,5,3,3,11,3
CM-2115,2014-11-12,49,3,277.53000000000003,5,1,4,10,3
CM-2160,2014-12-11,20,5,314.12999999999994,7,2,4,13,4
CM-2190,2014-11-02,59,4,-480.6899999999999,4,1,1,6,1
CM-2235,2014-10-11,81,5,-66.29999999999998,4,2,2,8,2
CM-2385,2013-05-06,604,4,-19.926,1,1,2,4,1
CM-2445,2014-01-17,348,4,288.52799999999996,1,1,4,6,1
CM-2655,2014-11-11,50,12,-221.106,5,5,2,12,4
CM-2715,2014-05-09,236,7,294.954,1,3,4,8,2
CP-12085,2014-10-23,69,23,620.3837000000001,4,7,6,17,5
CP-12340,2014-12-23,8,30,182.97138000000015,9,9,4,22,8
CP-2085,2014-11-08,53,10,1130.1899999999998,5,5,7,17,5
CP-2340,2013-09-24,463,4,1565.31,1,1,8,10,3
CR-12580,2014-11-25,36,20,818.0318000000002,6,6,6,18,6
CR-12625,2014-11-18,43,28,1478.5750799999998,5,9,8,22,8
CR-12730,2014-10-14,78,24,1648.0413600000002,4,7,8,19,6
CR-12820,2014-10-28,64,24,3391.1884600000003,4,7,10,21,7
CR-2580,2014-11-27,34,5,1127.964,6,2,7,15,5
CR-2625,2014-12-06,25,9,866.547,7,5,6,18,6
CR-2730,2014-12-26,5,11,-212.604,10,5,2,17,5
CR-2820,2014-09-01,121,8,-78.46799999999998,3,4,2,9,2
CS-11845,2014-12-16,15,26,3274.9862000000003,8,8,10,26,9
CS-11860,2014-10-15,77,21,970.3403199999998,4,6,7,17,5
CS-11950,2014-11-16,45,31,-1148.07796,5,10,1,16,5
CS-12130,2014-12-20,11,22,641.4549000000002,9,6,6,21,7
CS-12175,2014-08-22,131,29,3114.008799999999,2,9,10,21,7
CS-12250,2014-11-24,37,30,2210.8319,6,9,9,24,9
CS-12355,2014-12-25,6,31,-115.63180000000023,9,10,2,21,7
CS-12400,2014-12-30,1,23,1373.06256,10,7,7,24,9
CS-12460,2014-12-25,6,23,2801.2725799999994,9,7,10,26,9
CS-12490,2014-12-29,2,30,-422.25809999999996,10,9,1,20,7
CS-12505,2014-06-18,196,16,-6437.3681,2,6,1,9,2
CS-1845,2014-07-12,172,8,-359.6580000000001,2,4,1,7,1
CS-1860,2014-11-11,50,9,349.55400000000003,5,5,5,15,5
CS-1950,2014-09-05,117,5,148.00199999999998,3,2,3,8,2
CS-2130,2014-01-03,362,4,-645.5219999999999,1,1,1,3,1
CS-2175,2014-04-20,255,5,1214.5680000000002,1,2,7,10,3
CS-2250,2014-12-29,2,4,391.67400000000004,10,1,5,16,5
CS-2355,2014-09-18,104,9,114.47999999999999,3,5,3,11,3
CS-2400,2014-12-20,11,5,706.9800000000001,9,2,6,17,5
CS-2460,2014-12-06,25,8,141.83699999999993,7,4,3,14,4
CS-2490,2014-07-15,169,3,611.1299999999999,2,1,6,9,2
CS-2505,2014-11-11,50,7,285.80999999999995,5,3,4,12,4
CT-11995,2014-09-26,96,27,2509.39534,3,8,9,20,7
CT-1995,2012-08-11,872,2,-71.592,1,1,2,4,1
CV-12295,2014-11-22,39,20,1126.4462799999997,6,6,7,19,6
CV-12805,2014-12-27,4,20,1737.4445000000012,10,6,8,24,9
CV-2295,2014-12-09,22,9,-521.1090000000002,7,5,1,13,4
CV-2805,2014-04-18,257,7,172.662,1,3,4,8,2
CW-11905,2014-12-23,8,25,2635.8494,9,7,10,26,9
CW-1905,2013-12-12,384,4,371.54999999999995,1,1,5,7,1
CY-12745,2014-12-06,25,31,1721.258999999999,7,10,8,25,9
CY-2745,2013-08-26,492,4,-179.01600000000002,1,1,2,4,1
Co-12640,2014-12-27,4,25,1295.1629599999997,10,7,7,24,9
Co-2640,2014-03-01,305,5,-99.12299999999995,1,2,2,5,1
DA-13450,2014-12-18,13,25,-826.0713400000006,8,7,1,16,5
DA-3450,2014-12-17,14,4,528.2399999999999,8,1,5,14,4
DB-12910,2014-12-29,2,27,781.9895,10,8,6,24,9
DB-12970,2014-05-28,217,11,463.24490000000014,2,5,5,12,4
DB-13060,2014-12-15,16,26,3315.622860000001,8,8,10,26,9
DB-13120,2014-12-26,5,16,-2028.578580000001,10,6,1,17,5
DB-13210,2014-12-24,7,27,1479.9668000000006,9,8,8,25,9
DB-13270,2014-12-22,9,25,1420.4588999999999,9,7,8,24,9
DB-13360,2014-11-14,47,28,848.4468600000001,5,9,6,20,7
DB-13405,2014-09-15,107,26,1988.81386,3,8,9,20,7
DB-13555,2014-11-25,36,22,943.0146000000003,6,6,6,18,6
DB-13615,2014-11-28,33,28,1995.248,6,9,9,24,9
DB-13660,2014-12-19,12,20,1267.3363400000003,8,6,7,21,7
DB-2910,2014-10-01,91,8,874.9499999999999,3,4,6,13,4
DB-2970,2014-05-27,218,4,123.72,2,1,3,6,1
DB-3060,2014-12-23,8,8,336.738,9,4,4,17,5
DB-3120,2014-07-01,183,4,-242.11800000000002,2,1,1,4,1
DB-3210,2013-12-04,392,7,-54.159000000000006,1,3,2,6,1
DB-3270,2014-11-13,48,2,219.77999999999997,5,1,4,10,3
DB-3360,2013-10-23,434,2,1074.27,1,1,7,9,2
DB-3405,2013-06-22,557,2,-30.257999999999996,1,1,2,4,1
DB-3555,2014-12-26,5,3,299.262,10,1,4,15,5
DB-3615,2014-09-15,107,4,972.432,3,1,7,11,3
DB-3660,2014-08-05,148,3,150.46200000000005,2,1,3,6,1
DC-12850,2014-11-24,37,29,-659.5637999999998,6,9,1,16,5
DC-13285,2014-12-13,18,23,1043.3900999999998,8,7,7,22,8
DC-2850,2014-11-27,34,9,589.0740000000001,6,5,5,16,5
DC-3285,2013-07-01,548,4,-178.05599999999998,1,1,2,4,1
DD-13570,2014-12-09,22,24,959.7672,7,7,6,20,7
DD-3570,2014-10-29,63,8,439.88399999999996,4,4,5,13,4
DE-13255,2014-12-12,19,22,1657.8873999999996,7,6,8,21,7
DE-3255,2014-11-13,48,8,77.61,5,4,3,12,4
DF-13135,2014-12-22,9,18,474.00019999999995,9,6,5,20,7
DF-3135,2014-11-18,43,4,-110.92799999999998,5,1,2,8,2
DG-13300,2014-11-29,32,28,2067.2561000000005,6,9,9,24,9
DG-3300,2014-12-17,14,6,307.062,8,2,4,14,4
DH-13075,2014-11-09,52,25,1370.5765,5,7,7,19,6
DH-13675,2014-10-12,80,17,842.9994999999998,4,6,6,16,5
DH-3075,2014-07-25,159,10,311.292,2,5,4,11,3
DH-3675,2014-11-12,49,12,1308.144,5,5,7,17,5
DJ-13420,2014-11-11,50,28,3173.1361400000005,5,9,10,24,9
DJ-13510,2014-12-25,6,31,2695.8619999999996,9,10,10,29,10
DJ-13630,2014-12-19,12,27,2205.876399999999,8,8,9,25,9
DJ-3420,2014-12-30,1,4,82.25999999999999,10,1,3,14,4
DJ-3510,2014-12-25,6,7,1614.6,9,3,8,20,7
DJ-3630,2014-11-27,34,6,469.8780000000001,6,2,5,13,4
DK-12835,2014-10-22,70,32,2632.1874999999995,4,10,10,24,9
DK-12895,2014-11-16,45,22,1080.6627600000002,5,6,7,18,6
DK-12985,2014-12-30,1,35,1366.8046999999995,10,10,7,27,10
DK-13090,2014-12-23,8,36,4004.4356999999995,9,10,10,29,10
DK-13150,2014-12-21,10,22,2064.7236999999996,9,6,9,24,9
DK-13225,2014-12-30,1,29,898.3239999999996,10,9,6,25,9
DK-13375,2014-12-27,4,26,2159.7979000000005,10,8,9,27,10
DK-2835,2014-10-12,80,11,285.66299999999995,4,5,4,13,4
DK-2895,2014-07-25,159,6,282.9,2,2,4,8,2
DK-2985,2011-12-09,1118,1,-78.888,1,1,2,4,1
DK-3090,2014-10-24,68,3,76.128,4,1,3,8,2
DK-3150,2014-04-11,264,14,114.414,1,5,3,9,2
DK-3225,2014-12-09,22,8,108.77399999999999,7,4,3,14,4
DK-3375,2014-12-08,23,10,805.71,7,5,6,18,6
DL-12865,2014-09-22,100,34,280.3309999999999,3,10,4,17,5
DL-12925,2014-12-06,25,21,1411.7939999999999,7,6,8,21,7
DL-13315,2014-12-13,18,27,2265.2256999999995,8,8,9,25,9
DL-13330,2014-12-19,12,34,2652.7522,8,10,10,28,10
DL-13495,2014-10-28,64,27,2474.763999999999,4,8,9,21,7
DL-2865,2014-12-06,25,7,145.70399999999998,7,3,3,13,4
DL-2925,2014-11-24,37,7,-303.3540000000001,6,3,1,10,3
DL-3315,2014-11-14,47,6,533.3100000000002,5,2,5,12,4
DL-3330,2013-01-25,705,3,94.74000000000001,1,1,3,5,1
DL-3495,2014-03-24,282,5,-913.8960000000001,1,2,1,4,1
DM-12955,2014-11-21,40,32,2206.22022,6,10,9,25,9
DM-13015,2014-12-26,5,30,1530.8618999999992,10,9,8,27,10
DM-13345,2014-12-29,2,27,2876.807100000001,10,8,10,28,10
DM-13525,2014-11-26,35,19,-925.5615200000001,6,6,1,13,4
DM-2955,2014-12-19,12,9,100.70700000000001,8,5,3,16,5
DM-3015,2014-12-29,2,6,460.88999999999993,10,2,5,17,5
DM-3345,2014-08-08,145,6,-5474.61,2,2,1,5,1
DM-3525,2014-11-02,59,6,652.146,4,2,6,12,4
DN-13690,2014-12-12,19,24,711.4185000000001,7,7,6,20,7
DN-3690,2014-12-19,12,5,-477.8759999999999,8,2,1,11,3
DO-13435,2014-10-28,64,32,3207.4254,4,10,10,24,9
DO-13645,2014-11-28,33,25,1997.8325200000006,6,7,9,22,8
DO-3435,2014-11-25,36,10,930.21,6,5,6,17,5
DO-3645,2014-11-20,41,5,-181.09799999999993,5,2,2,9,2
DP-13000,2014-10-31,61,31,-949.6011999999997,4,10,1,15,5
DP-13105,2014-12-25,6,25,3099.9463000000005,9,7,10,26,9
DP-13165,2014-12-24,7,25,1808.3185200000005,9,7,8,24,9
DP-13390,2014-12-31,0,27,2369.8289999999997,10,8,9,27,10
DP-3000,2014-12-17,14,10,432.15,8,5,5,18,6
DP-3105,2014-10-28,64,6,1500.186,4,2,8,14,4
DP-3165,2014-12-24,7,6,-973.788,9,2,1,12,4
DP-3390,2014-12-19,12,6,318.36,8,2,4,14,4
DR-12880,2014-12-28,3,32,2112.6456000000003,10,10,9,29,10
DR-12940,2014-12-08,23,33,5505.922919999999,7,10,10,27,10
DR-2880,2014-12-27,4,8,-128.247,10,4,2,16,5
DR-2940,2014-11-22,39,8,598.0500000000002,6,4,6,16,5
DS-13030,2014-09-29,93,26,1068.3454,3,8,7,18,6
DS-13180,2014-12-17,14,31,1669.7884999999994,8,10,8,26,9
DS-3030,2014-11-13,48,6,419.32199999999995,5,2,5,12,4
DS-3180,2014-11-02,59,2,43.626000000000005,4,1,3,8,2
DV-13045,2014-12-12,19,24,599.18592,7,7,6,20,7
DV-13465,2014-12-06,25,20,2167.6825800000006,7,6,9,22,8
DV-3045,2014-11-28,33,13,17.138999999999974,6,5,2,13,4
DV-3465,2014-12-18,13,5,1175.04,8,2,7,17,5
DW-13195,2014-12-25,6,26,1623.3822999999998,9,8,8,25,9
DW-13480,2014-10-27,65,23,3315.6931999999983,4,7,10,21,7
DW-13540,2014-12-19,12,20,1471.8721999999998,8,6,8,22,8
DW-13585,2014-12-26,5,37,821.8129999999996,10,10,6,26,9
DW-3195,2012-02-02,1063,4,115.716,1,1,3,5,1
DW-3480,2014-10-07,85,12,1713.3960000000004,4,5,8,17,5
DW-3540,2014-07-11,173,4,-1046.1630000000002,2,1,1,4,1
DW-3585,2014-08-01,152,4,48.74399999999999,2,1,3,6,1
Dl-13600,2014-12-26,5,20,1722.9402000000002,10,6,8,24,9
Dl-3600,2014-11-09,52,10,128.76600000000005,5,5,3,13,4
Dp-13240,2014-12-13,18,28,3822.69412,8,9,10,27,10
Dp-3240,2014-06-26,188,7,136.47,2,3,3,8,2
EA-14035,2014-09-29,93,31,867.1721200000003,3,10,6,19,6
EA-4035,2014-07-19,165,3,0.8879999999999981,2,1,2,5,1
EB-13705,2014-11-13,48,30,894.0076000000001,5,9,6,20,7
EB-13750,2014-11-29,32,20,1368.5910000000001,6,6,7,19,6
EB-13840,2014-12-29,2,25,5466.499739999999,10,7,10,27,10
EB-13870,2014-12-16,15,19,187.37620000000007,8,6,4,18,6
EB-13930,2014-12-12,19,18,1385.4760999999996,7,6,7,20,7
EB-13975,2014-12-31,0,32,2653.544400000001,10,10,10,30,10
EB-14110,2014-11-26,35,24,3285.6169000000004,6,7,10,23,8
EB-14170,2014-12-12,19,23,276.7832000000001,7,7,4,18,6
EB-3705,2013-11-28,398,3,594.6,1,1,6,8,2
EB-3750,2014-06-30,184,6,118.56299999999996,2,2,3,7,1
EB-3840,2014-11-18,43,6,382.24800000000005,5,2,5,12,4
EB-3870,2013-09-05,482,5,-166.818,1,2,2,5,1
EB-3930,2014-12-24,7,9,706.266,9,5,6,20,7
EB-3975,2014-11-26,35,9,377.18999999999994,6,5,5,16,5
EB-4110,2014-11-12,49,10,-391.953,5,5,1,11,3
EB-4170,2014-07-11,173,6,288.84,2,2,4,8,2
EC-14050,2014-11-09,52,19,424.05770000000024,5,6,5,16,5
EC-4050,2014-07-22,162,7,407.71500000000015,2,3,5,10,3
ED-13885,2014-12-16,15,31,2933.2625000000003,8,10,10,28,10
ED-3885,2014-10-15,77,8,-360.816,4,4,1,9,2
EG-13900,2014-12-08,23,21,3360.5462799999996,7,6,10,23,8
EG-3900,2014-11-08,53,11,-756.3090000000001,5,5,1,11,3
EH-13765,2014-12-29,2,29,1685.9614,10,9,8,27,10
EH-13945,2014-09-25,97,27,1551.0848200000003,3,8,8,19,6
EH-13990,2014-11-17,44,26,1552.3204999999998,5,8,8,21,7
EH-14005,2014-12-29,2,28,285.6472999999998,10,9,4,23,8
EH-14125,2014-09-20,102,31,2105.89082,3,10,9,22,8
EH-14185,2014-11-06,55,29,1241.8905199999995,5,9,7,21,7
EH-3765,2014-10-06,86,9,-1014.7679999999999,4,5,1,10,3
EH-3945,2014-12-03,28,9,698.9700000000001,6,5,6,17,5
EH-3990,2014-11-28,33,6,4.598999999999993,6,2,2,10,3
EH-4005,2014-06-18,196,7,509.00399999999996,2,3,5,10,3
EH-4125,2014-10-30,62,13,-445.55999999999995,4,5,1,10,3
EH-4185,2014-08-25,128,8,1039.62,3,4,7,14,4
EJ-13720,2014-12-11,20,22,1012.9436,7,6,7,20,7
EJ-14155,2014-11-27,34,23,1975.1191000000006,6,7,9,22,8
EJ-3720,2014-07-28,156,8,197.00399999999993,2,4,4,10,3
EJ-4155,2014-09-12,110,5,819.4499999999999,3,2,6,11,3
EK-13795,2014-11-17,44,17,593.1248,5,6,6,17,5
EK-3795,2014-02-06,328,6,172.35299999999998,1,2,4,7,1
EL-13735,2014-10-15,77,23,1142.5973999999999,4,7,7,18,6
EL-3735,2014-06-13,201,11,12.942000000000057,2,5,2,9,2
EM-13810,2014-10-14,78,23,1664.8005399999997,4,7,8,19,6
EM-13825,2014-10-05,87,26,2018.1443600000011,4,8,9,21,7
EM-13960,2014-12-29,2,37,2593.94148,10,10,10,30,10
EM-14065,2014-12-15,16,17,3017.7341799999986,8,6,10,24,9
EM-14095,2014-12-23,8,17,1684.9539,9,6,8,23,8
EM-14140,2014-11-15,46,30,3683.1207600000002,5,9,10,24,9
EM-14200,2014-11-20,41,23,3138.3377600000013,5,7,10,22,8
EM-3810,2014-06-24,190,6,232.56899999999996,2,2,4,8,2
EM-3825,2013-09-03,484,6,-30.072,1,2,2,5,1
EM-3960,2014-07-05,179,8,712.074,2,4,6,12,4
EM-4065,2014-10-22,70,9,921.726,4,5,6,15,5
EM-4095,2014-09-04,118,9,79.82999999999998,3,5,3,11,3
EM-4140,2014-09-29,93,6,-58.869,3,2,2,7,1
EM-4200,2014-06-23,191,4,509.118,2,1,5,8,2
EN-13780,2014-12-17,14,20,478.5335000000001,8,6,5,19,6
EN-3780,2014-09-06,116,8,-240.834,3,4,1,8,2
EP-13915,2014-12-19,12,33,2159.58474,8,10,9,27,10
EP-3915,2014-10-17,75,3,-55.61999999999999,4,1,2,7,1
ER-13855,2014-10-23,69,19,2212.0921999999996,4,6,9,19,6
ER-3855,2014-10-09,83,7,373.6260000000001,4,3,5,12,4
ES-14020,2014-12-31,0,32,2761.388440000001,10,10,10,30,10
ES-14080,2014-09-20,102,24,1925.1879000000001,3,7,9,19,6
ES-4020,2014-03-12,294,7,365.98800000000006,1,3,5,9,2
ES-4080,2014-08-08,145,9,250.104,2,5,4,11,3
FA-14230,2014-11-23,38,29,1245.2617000000002,6,9,7,22,8
FA-4230,2014-06-30,184,6,250.932,2,2,4,8,2
FC-14245,2014-11-19,42,23,2492.3229999999994,5,7,9,21,7
FC-14335,2014-09-15,107,23,1329.9262400000002,3,7,7,17,5
FC-4245,2013-08-27,491,6,288.468,1,2,4,7,1
FC-4335,2014-12-09,22,4,166.77,7,1,4,12,4
FG-14260,2014-11-27,34,18,1158.0511999999999,6,6,7,19,6
FG-4260,2014-12-09,22,9,-123.93900000000004,7,5,2,14,4
FH-14275,2014-12-27,4,23,3539.4216,10,7,10,27,10
FH-14350,2014-12-30,1,20,2959.86382,10,6,10,26,9
FH-14365,2014-12-30,1,30,4101.913119999998,10,9,10,29,10
FH-4275,2014-09-05,117,5,8.154000000000003,3,2,2,7,1
FH-4350,2014-12-17,14,3,-71.82900000000001,8,1,2,11,3
FH-4365,2014-07-18,166,9,507.378,2,5,5,12,4
FM-14215,2014-12-24,7,31,1000.9705999999998,9,10,7,26,9
FM-14290,2014-12-10,21,30,2191.5807200000004,7,9,9,25,9
FM-14380,2014-08-08,145,21,1461.1015000000002,2,6,8,16,5
FM-4215,2014-09-26,96,6,393.054,3,2,5,10,3
FM-4290,2014-12-29,2,8,409.71,10,4,5,19,6
FM-4380,2014-12-30,1,6,-445.59000000000003,10,2,1,13,4
FO-14305,2014-12-11,20,37,2567.1143999999995,7,10,9,26,9
FO-4305,2014-12-09,22,10,456.636,7,5,5,17,5
FP-14320,2014-09-08,114,29,840.6415000000003,3,9,6,18,6
FP-4320,2014-11-27,34,5,96.55199999999998,6,2,3,11,3
FW-14395,2014-10-29,63,26,1651.7593999999997,4,8,8,20,7
FW-4395,2014-12-31,0,8,32.031,10,4,3,17,5
GA-14515,2014-10-13,79,24,1108.47532,4,7,7,18,6
GA-14725,2014-12-29,2,24,1012.2714000000002,10,7,7,24,9
GA-4515,2014-11-26,35,7,-316.1310000000001,6,3,1,10,3
GA-4725,2014-10-22,70,4,-240.29399999999998,4,1,1,6,1
GB-14530,2014-12-03,28,25,560.6201,6,7,5,18,6
GB-14575,2014-12-18,13,24,1621.013680000001,8,7,8,23,8
GB-4530,2014-09-09,113,5,95.66999999999999,3,2,3,8,2
GB-4575,2014-05-06,239,6,12.251999999999992,1,2,2,5,1
GD-14590,2014-12-26,5,29,1826.5178999999996,10,9,8,27,10
GD-4590,2014-01-13,352,4,61.632000000000005,1,1,3,5,1
GG-14650,2014-11-28,33,28,1491.5912599999997,6,9,8,23,8
GG-4650,2014-12-03,28,5,31.932000000000006,6,2,3,11,3
GH-14410,2014-11-12,49,36,47.46547999999994,5,10,3,18,6
GH-14425,2014-12-13,18,31,3375.2250999999983,8,10,10,28,10
GH-14485,2014-12-05,26,21,2200.7504,7,6,9,22,8
GH-14665,2014-12-29,2,29,1877.9406199999996,10,9,9,28,10
GH-4410,2014-09-03,119,9,566.34,3,5,5,13,4
GH-4425,2014-10-12,80,10,532.8899999999998,4,5,5,14,4
GH-4485,2014-07-10,174,4,95.20200000000001,2,1,3,6,1
GH-4665,2014-12-30,1,9,-293.271,10,5,1,16,5
GK-14620,2014-12-19,12,24,3611.1624000000015,8,7,10,25,9
GK-4620,2014-09-22,100,4,-115.869,3,1,2,6,1
GM-14440,2014-12-12,19,26,1431.27788,7,8,8,23,8
GM-14455,2014-12-15,16,17,3106.2264,8,6,10,24,9
GM-14500,2014-12-05,26,23,531.42212,7,7,5,19,6
GM-14680,2014-12-30,1,31,-1804.8220599999993,10,10,1,21,7
GM-14695,2014-12-09,22,19,-71.28050000000033,7,6,2,15,5
GM-4440,2014-12-30,1,8,233.73600000000002,10,4,4,18,6
GM-4455,2014-06-06,208,4,-234.12000000000003,2,1,2,5,1
GM-4500,2014-09-18,104,5,1021.83,3,2,7,12,4
GM-4680,2014-10-20,72,6,466.902,4,2,5,11,3
GM-4695,2014-05-23,222,7,59.922,2,3,3,8,2
GP-14740,2014-12-30,1,25,377.6766000000001,10,7,5,22,8
GP-4740,2014-06-27,187,8,872.4330000000006,2,4,6,12,4
GR-14560,2014-12-11,20,24,1030.9907399999997,7,7,7,21,7
GR-4560,2014-07-31,153,6,-534.711,2,2,1,5,1
GT-14635,2014-11-02,59,20,-3790.0830599999986,4,6,1,11,3
GT-14710,2014-12-23,8,30,5164.847179999999,9,9,10,28,10
GT-14755,2014-11-27,34,23,593.33132,6,7,6,19,6
GT-4635,2014-12-22,9,7,212.16000000000003,9,3,4,16,5
GT-4710,2014-06-11,203,4,49.283999999999914,2,1,3,6,1
GT-4755,2014-12-31,0,8,190.84799999999996,10,4,4,18,6
GW-14605,2014-12-13,18,25,934.7201999999999,8,7,6,21,7
GW-4605,2014-12-17,14,8,264.33900000000006,8,4,4,16,5
GZ-14470,2014-12-24,7,35,2885.9929000000006,9,10,10,29,10
GZ-14545,2014-11-06,55,24,2645.299800000001,5,7,10,22,8
GZ-4470,2014-06-08,206,8,856.4459999999998,2,4,6,12,4
GZ-4545,2014-12-05,26,6,1460.2979999999998,7,2,8,17,5
HA-14905,2014-11-09,52,24,-526.0681600000003,5,7,1,13,4
HA-14920,2014-12-09,22,25,1457.3645999999999,7,7,8,22,8
HA-4905,2014-12-18,13,4,-235.62599999999998,8,1,1,10,3
HA-4920,2014-08-20,133,6,103.794,2,2,3,7,1
HD-14785,2014-12-03,28,29,1803.144199999999,6,9,8,23,8
HD-4785,2014-09-16,106,7,828.0479999999999,3,3,6,12,4
HE-14800,2014-12-25,6,27,1570.1460200000006,9,8,8,25,9
HE-4800,2014-11-25,36,8,140.29199999999997,6,4,3,13,4
HF-14995,2014-12-17,14,28,-474.8709,8,9,1,18,6
HF-4995,2013-08-03,515,8,-178.25699999999998,1,4,2,7,1
HG-14845,2014-12-19,12,30,-824.0102800000002,8,9,1,18,6
HG-14965,2014-10-31,61,34,-1607.2489,4,10,1,15,5
HG-15025,2014-12-25,6,29,1357.6438999999998,9,9,7,25,9
HG-4845,2014-12-08,23,9,532.5180000000001,7,5,5,17,5
HG-4965,2014-09-23,99,5,9.738000000000023,3,2,2,7,1
HG-5025,2014-09-26,96,7,175.272,3,3,4,10,3
HH-15010,2014-10-31,61,24,2109.31402,4,7,9,20,7
HH-5010,2014-06-18,196,3,323.01,2,1,4,7,1
HJ-14875,2014-12-26,5,32,2324.021,10,10,9,29,10
HJ-4875,2014-02-24,310,6,294.23999999999995,1,2,4,7,1
HK-14890,2014-11-18,43,27,2306.944199999999,5,8,9,22,8
HK-4890,2014-07-14,170,6,187.986,2,2,4,8,2
HL-15040,2014-12-08,23,20,7657.501779999998,7,6,10,23,8
HL-5040,2014-06-26,188,4,159.066,2,1,3,6,1
HM-14860,2014-12-30,1,37,6544.886399999999,10,10,10,30,10
HM-14980,2014-12-04,27,29,1044.7111,7,9,7,23,8
HM-4860,2014-11-27,34,4,413.4,6,1,5,12,4
HM-4980,2013-09-23,464,5,1628.628,1,2,8,11,3
HP-14815,2014-09-20,102,24,636.2192,3,7,6,16,5
HP-4815,2014-12-02,29,5,244.00199999999998,6,2,4,12,4
HR-14770,2014-12-18,13,18,1182.9004000000002,8,6,7,21,7
HR-14830,2014-10-11,81,21,1517.8777600000003,4,6,8,18,6
HR-4770,2014-06-27,187,8,522.3720000000001,2,4,5,11,3
HR-4830,2014-05-08,237,3,-61.842000000000006,1,1,2,4,1
HW-14935,2014-11-27,34,28,2653.6990999999994,6,9,10,25,9
HW-4935,2014-08-29,124,7,-98.586,3,3,2,8,2
HZ-14950,2014-11-26,35,22,1003.4369,6,6,7,19,6
HZ-4950,2014-06-06,208,6,-261.954,2,2,1,5,1
IG-15085,2014-12-18,13,25,657.4951800000002,8,7,6,21,7
IG-5085,2014-12-30,1,12,1253.673,10,5,7,22,8
IL-15100,2014-11-08,53,25,1244.23476,5,7,7,19,6
IL-5100,2014-07-21,163,7,-63.16199999999998,2,3,2,7,1
IM-15055,2014-12-16,15,15,1534.0298599999996,8,6,8,22,8
IM-15070,2014-11-21,40,27,-567.6301799999997,6,8,1,15,5
IM-5055,2014-12-12,19,7,913.95,7,3,6,16,5
IM-5070,2014-12-05,26,7,-112.67399999999998,7,3,2,12,4
JA-15970,2014-12-31,0,25,688.9729999999997,10,7,6,23,8
JA-5970,2014-12-31,0,7,153.357,10,3,3,16,5
JB-15400,2014-12-24,7,34,1992.2621000000001,9,10,9,28,10
JB-15925,2014-12-22,9,19,1649.1341599999996,9,6,8,23,8
JB-16000,2014-12-30,1,32,2936.3772200000003,10,10,10,30,10
JB-16045,2014-12-31,0,24,778.6291799999997,10,7,6,23,8
JB-5400,2014-10-10,82,7,459.5999999999999,4,3,5,12,4
JB-5925,2014-10-24,68,8,-518.6280000000002,4,4,1,9,2
JB-6000,2014-10-07,85,7,-68.45399999999995,4,3,2,9,2
JB-6045,2014-10-06,86,10,-529.5840000000001,4,5,1,10,3
JC-15340,2014-11-27,34,29,239.28599999999997,6,9,4,19,6
JC-15385,2014-12-23,8,25,2086.7973199999997,9,7,9,25,9
JC-15775,2014-12-30,1,25,1820.4692400000001,10,7,8,25,9
JC-16105,2014-10-24,68,28,712.31408,4,9,6,19,6
JC-5340,2014-11-08,53,6,98.50499999999998,5,2,3,10,3
JC-5385,2014-12-16,15,9,-782.2350000000001,8,5,1,14,4
JC-5775,2014-12-18,13,5,37.91699999999999,8,2,3,13,4
JC-6105,2014-12-07,24,6,-2601.42,7,2,1,10,3
JD-15790,2014-12-16,15,24,-293.6847400000001,8,7,1,16,5
JD-15895,2014-12-25,6,32,1430.5470200000007,9,10,8,27,10
JD-16015,2014-12-07,24,24,-29.400199999999984,7,7,2,16,5
JD-16060,2014-11-06,55,19,-24.026940000000113,5,6,2,13,4
JD-16150,2014-12-31,0,28,1430.44888,10,9,8,27,10
JD-5790,2014-07-03,181,5,-905.028,2,2,1,5,1
JD-5895,2014-12-29,2,6,296.24399999999997,10,2,4,16,5
JD-6015,2014-11-19,42,8,-575.0099999999999,5,4,1,10,3
JD-6060,2014-08-13,140,9,588.9300000000002,2,5,5,12,4
JD-6150,2014-10-12,80,6,1194.8700000000001,4,2,7,13,4
JE-15475,2014-11-26,35,22,1223.3236999999997,6,6,7,19,6
JE-15610,2014-11-19,42,26,1780.0783,5,8,8,21,7
JE-15715,2014-12-22,9,36,3648.0085000000013,9,10,10,29,10
JE-15745,2014-11-29,32,35,1123.48066,6,10,7,23,8
JE-16165,2014-11-20,41,20,1839.8079600000008,5,6,8,19,6
JE-5475,2014-07-10,174,8,94.848,2,4,3,9,2
JE-5610,2014-09-07,115,6,-408.165,3,2,1,6,1
JE-5715,2014-06-10,204,7,-27.119999999999997,2,3,2,7,1
JE-5745,2014-06-20,194,7,405.29999999999995,2,3,5,10,3
JE-6165,2014-12-04,27,8,1088.4959999999999,7,4,7,18,6
JF-15190,2014-12-25,6,28,4108.5473999999995,9,9,10,28,10
JF-15295,2014-09-18,104,24,3263.2952999999998,3,7,10,20,7
JF-15355,2014-12-18,13,22,1016.671,8,6,7,21,7
JF-15415,2014-12-29,2,23,1396.6454799999997,10,7,7,24,9
JF-15490,2014-12-27,4,30,1048.3175599999997,10,9,7,26,9
JF-15565,2014-12-30,1,29,4329.94546,10,9,10,29,10
JF-5190,2014-07-02,182,8,-2385.942000000001,2,4,1,7,1
JF-5295,2014-10-29,63,8,-570.7680000000001,4,4,1,9,2
JF-5355,2014-09-26,96,9,-2891.3460000000005,3,5,1,9,2
JF-5415,2014-11-24,37,11,1270.2,6,5,7,18,6
JF-5490,2014-09-23,99,7,151.78499999999997,3,3,3,9,2
JF-5565,2013-12-08,388,6,547.74,1,2,5,8,2
JG-15115,2014-10-24,68,19,1161.6409800000004,4,6,7,17,5
JG-15160,2014-12-30,1,32,4498.9944,10,10,10,30,10
JG-15310,2014-12-29,2,24,2095.911500000001,10,7,9,26,9
JG-15805,2014-12-31,0,37,3393.2201000000005,10,10,10,30,10
JG-5115,2014-12-26,5,9,-2083.9019999999996,10,5,1,16,5
JG-5160,2014-12-15,16,8,50.10600000000001,8,4,3,15,5
JG-5310,2014-11-18,43,5,158.72400000000002,5,2,3,10,3
JG-5805,2014-08-20,133,3,-112.44000000000001,2,1,2,5,1
JH-15430,2014-12-26,5,31,1477.1982000000003,10,10,8,28,10
JH-15820,2014-12-18,13,31,4829.672700000002,8,10,10,28,10
JH-15910,2014-11-20,41,32,1635.3961999999995,5,10,8,23,8
JH-15985,2014-12-20,11,38,-182.93179999999978,9,10,2,21,7
JH-16180,2014-11-11,50,31,2588.2793999999994,5,10,9,24,9
JH-5430,2014-12-24,7,9,113.49600000000001,9,5,3,17,5
JH-5820,2014-11-19,42,7,566.151,5,3,5,13,4
JH-5910,2014-11-21,40,8,-930.336,6,4,1,11,3
JH-5985,2014-09-11,111,7,569.6099999999999,3,3,5,11,3
JH-6180,2014-11-07,54,9,1406.3850000000002,5,5,7,17,5
JJ-15445,2014-11-28,33,19,1054.3552000000002,6,6,7,19,6
JJ-15760,2014-12-29,2,28,1755.5902799999994,10,9,8,27,10
JJ-5445,2014-12-12,19,6,-31.655999999999985,7,2,2,11,3
JJ-5760,2014-07-04,180,6,93.39599999999994,2,2,3,7,1
JK-15205,2014-10-31,61,24,2359.562200000001,4,7,9,20,7
JK-15325,2014-11-01,60,28,2059.3590200000003,4,9,9,22,8
JK-15370,2014-12-30,1,27,1813.4958400000005,10,8,8,26,9
JK-15625,2014-12-30,1,27,2805.6486,10,8,10,28,10
JK-15640,2014-12-31,0,26,2651.1058000000003,10,8,10,28,10
JK-15730,2014-11-13,48,34,2283.760299999999,5,10,9,24,9
JK-16090,2014-12-23,8,33,3195.3713399999992,9,10,10,29,10
JK-16120,2014-12-09,22,26,1594.4992400000006,7,8,8,23,8
JK-5205,2013-07-01,548,5,404.22,1,2,5,8,2
JK-5325,2013-09-27,460,3,-36.97200000000001,1,1,2,4,1
JK-5370,2014-09-08,114,6,-263.4480000000002,3,2,1,6,1
JK-5625,2014-02-18,316,8,1170.693,1,4,7,12,4
JK-5640,2014-11-07,54,4,103.17000000000002,5,1,3,9,2
JK-5730,2013-08-30,488,6,2089.7400000000002,1,2,9,12,4
JK-6090,2014-12-19,12,5,-1397.1240000000003,8,2,1,11,3
JK-6120,2014-08-13,140,6,299.7,2,2,4,8,2
JL-15130,2014-12-23,8,28,967.87754,9,9,7,25,9
JL-15175,2014-12-25,6,27,1268.0311599999993,9,8,7,24,9
JL-15235,2014-12-18,13,24,4370.947040000002,8,7,10,25,9
JL-15505,2014-12-11,20,22,644.2673000000001,7,6,6,19,6
JL-15835,2014-11-25,36,30,1576.5370000000003,6,9,8,23,8
JL-15850,2014-11-17,44,22,988.2485999999999,5,6,7,18,6
JL-5130,2014-06-17,197,12,72.30000000000017,2,5,3,10,3
JL-5175,2014-08-29,124,5,433.14,3,2,5,10,3
JL-5235,2014-12-30,1,4,359.7420000000001,10,1,5,16,5
JL-5505,2014-01-24,341,3,542.0100000000001,1,1,5,7,1
JL-5835,2014-07-11,173,7,816.4649999999999,2,3,6,11,3
JL-5850,2013-02-02,697,4,-634.002,1,1,1,3,1
JM-15250,2014-11-26,35,24,2152.673319999999,6,7,9,22,8
JM-15265,2014-12-10,21,29,2623.9919999999993,7,9,10,26,9
JM-15535,2014-12-17,14,20,1460.2395000000001,8,6,8,22,8
JM-15580,2014-12-31,0,24,1540.2094,10,7,8,25,9
JM-15655,2014-12-23,8,34,1190.0740600000001,9,10,7,26,9
JM-15865,2014-10-24,68,29,2234.2469000000006,4,9,9,22,8
JM-16195,2014-12-06,25,25,1314.3129999999996,7,7,7,21,7
JM-5250,2014-12-25,6,5,-488.019,9,2,1,12,4
JM-5265,2014-04-18,257,4,156.102,1,1,3,5,1
JM-5535,2014-11-03,58,5,-101.31299999999997,4,2,2,8,2
JM-5580,2014-12-11,20,5,176.523,7,2,4,13,4
JM-5655,2014-08-31,122,8,608.4599999999999,3,4,6,13,4
JM-5865,2014-10-22,70,6,83.86800000000001,4,2,3,9,2
JM-6195,2014-12-19,12,8,205.48199999999994,8,4,4,16,5
JO-15145,2014-10-28,64,23,2280.951499999999,4,7,9,20,7
JO-15280,2014-12-17,14,21,1203.0993,8,6,7,21,7
JO-15550,2014-10-21,71,19,541.2968999999999,4,6,5,15,5
JO-5145,2014-12-26,5,6,764.3040000000001,10,2,6,18,6
JO-5280,2014-12-12,19,4,702.69,7,1,6,14,4
JO-5550,2014-12-19,12,9,41.459999999999994,8,5,3,16,5
JP-15460,2014-12-10,21,26,1639.9413200000006,7,8,8,23,8
JP-15520,2014-12-23,8,26,2854.746160000001,9,8,10,27,10
JP-16135,2014-11-18,43,34,2036.0101999999997,5,10,9,24,9
JP-5460,2014-06-26,188,10,439.488,2,5,5,12,4
JP-5520,2014-10-09,83,4,315.41400000000004,4,1,4,9,2
JP-6135,2014-07-22,162,8,1443.03,2,4,8,14,4
JR-15670,2014-12-19,12,20,-1185.9908999999993,8,6,1,15,5
JR-15700,2014-12-24,7,18,815.85476,9,6,6,21,7
JR-16210,2014-12-13,18,21,1221.946,8,6,7,21,7
JR-5670,2014-08-25,128,6,425.57400000000007,3,2,5,10,3
JR-5700,2014-12-18,13,6,116.673,8,2,3,13,4
JR-6210,2014-11-24,37,6,84.81,6,2,3,11,3
JS-15595,2014-12-26,5,18,562.5654999999999,10,6,5,21,7
JS-15685,2014-11-21,40,26,1848.0462999999995,6,8,9,23,8
JS-15880,2014-12-20,11,20,1471.0499000000004,9,6,8,23,8
JS-15940,2014-12-26,5,15,-26.756599999999953,10,6,2,18,6
JS-16030,2014-10-20,72,32,-675.4485199999999,4,10,1,15,5
JS-5595,2013-02-20,679,6,-723.7589999999999,1,2,1,4,1
JS-5685,2014-11-08,53,5,502.44,5,2,5,12,4
JS-5880,2014-07-03,181,6,-979.653,2,2,1,5,1
JS-5940,2014-08-19,134,13,38.73000000000002,2,5,3,10,3
JS-6030,2014-05-27,218,4,572.4480000000001,2,1,5,8,2
JW-15220,2014-12-19,12,34,4115.151699999999,8,10,10,28,10
JW-15955,2014-12-26,5,30,624.7968,10,9,6,25,9
JW-16075,2014-12-30,1,25,2677.4957000000004,10,7,10,27,10
JW-5220,2014-09-22,100,6,2150.694,3,2,9,14,4
JW-5955,2014-09-16,106,2,32.31,3,1,3,7,1
JW-6075,2014-09-04,118,4,272.52,3,1,4,8,2
KA-16525,2014-12-15,16,35,1299.91352,8,10,7,25,9
KA-6525,2014-09-29,93,7,101.48400000000001,3,3,3,9,2
KB-16240,2014-12-27,4,27,1801.5405999999996,10,8,8,26,9
KB-16315,2014-12-29,2,29,1420.0875799999985,10,9,8,27,10
KB-16405,2014-12-12,19,28,723.9984999999999,7,9,6,22,8
KB-16585,2014-10-02,90,27,1398.2126000000003,3,8,7,18,6
KB-16600,2014-12-30,1,25,887.3471,10,7,6,23,8
KB-6240,2014-06-13,201,7,517.53,2,3,5,10,3
KB-6315,2014-09-12,110,11,365.77500000000003,3,5,5,13,4
KB-6405,2013-09-12,475,3,-105.762,1,1,2,4,1
KB-6585,2013-12-25,371,2,-47.19,1,1,2,4,1
KB-6600,2014-12-22,9,11,158.89800000000005,9,5,3,17,5
KC-16255,2014-12-09,22,27,2139.7119999999995,7,8,9,24,9
KC-16540,2014-11-20,41,25,2343.8801599999993,5,7,9,21,7
KC-16675,2014-12-29,2,23,2265.91074,10,7,9,26,9
KC-6255,2014-04-11,264,8,-160.21200000000007,1,4,2,7,1
KC-6540,2014-11-28,33,7,14.223000000000003,6,3,2,11,3
KC-6675,2014-12-12,19,3,-120.94799999999998,7,1,2,10,3
KD-16270,2014-11-25,36,29,3914.2347,6,9,10,25,9
KD-16345,2014-11-20,41,15,2363.1305999999995,5,6,9,20,7
KD-16495,2014-11-15,46,36,5152.962499999999,5,10,10,25,9
KD-16615,2014-10-17,75,24,1720.54552,4,7,8,19,6
KD-6270,2012-11-10,781,1,-1023.54,1,1,1,3,1
KD-6345,2014-10-17,75,6,65.7,4,2,3,9,2
KD-6495,2013-11-28,398,4,333.2100000000001,1,1,4,6,1
KD-6615,2014-06-28,186,3,30.18,2,1,3,6,1
KE-16420,2014-11-14,47,31,1186.1554200000005,5,10,7,22,8
KE-6420,2014-04-24,251,4,100.392,1,1,3,5,1
KF-16285,2014-12-09,22,21,2976.3910999999994,7,6,10,23,8
KF-6285,2014-11-29,32,9,-591.1979999999999,6,5,1,12,4
KH-16330,2014-12-15,16,26,3205.8576000000003,8,8,10,26,9
KH-16360,2014-12-30,1,28,1542.2224999999992,10,9,8,27,10
KH-16510,2014-11-25,36,26,1713.8032000000005,6,8,8,22,8
KH-16630,2014-12-23,8,27,1205.6671600000002,9,8,7,24,9
KH-16690,2014-12-29,2,39,2367.4902,10,10,9,29,10
KH-6330,2014-12-12,19,13,405.1679999999998,7,5,5,17,5
KH-6360,2014-09-22,100,7,300.16499999999996,3,3,4,10,3
KH-6510,2014-12-16,15,7,483.03000000000014,8,3,5,16,5
KH-6630,2014-08-02,151,5,300.30600000000004,2,2,4,8,2
KH-6690,2014-07-05,179,7,3.083999999999989,2,3,2,7,1
KL-16555,2014-12-16,15,26,580.9184000000004,8,8,5,21,7
KL-16645,2014-11-14,47,28,812.6144999999996,5,9,6,20,7
KL-6555,2014-09-07,115,7,157.82999999999993,3,3,3,9,2
KL-6645,2014-12-31,0,5,-657.7139999999999,10,2,1,13,4
KM-16225,2014-12-31,0,18,227.23930000000001,10,6,4,20,7
KM-16375,2014-12-29,2,28,1194.4548400000006,10,9,7,26,9
KM-16660,2014-12-16,15,29,888.3437000000001,8,9,6,23,8
KM-16720,2014-09-15,107,23,1637.1664999999994,3,7,8,18,6
KM-6225,2013-12-25,371,3,142.29299999999998,1,1,3,5,1
KM-6375,2014-10-02,90,5,256.6289999999999,3,2,4,9,2
KM-6660,2014-09-10,112,3,-40.446,3,1,2,6,1
KM-6720,2014-01-16,349,3,1122.0240000000003,1,1,7,9,2
KN-16390,2014-12-12,19,29,4067.8225399999988,7,9,10,26,9
KN-16450,2014-11-24,37,26,2512.5944000000004,6,8,9,23,8
KN-16705,2014-12-06,25,19,935.5005000000003,7,6,6,19,6
KN-6390,2014-02-04,330,3,77.37,1,1,3,5,1
KN-6450,2014-09-29,93,8,-255.378,3,4,1,8,2
KN-6705,2014-08-30,123,5,763.008,3,2,6,11,3
KS-16300,2014-11-26,35,21,1079.99218,6,6,7,19,6
KS-6300,2014-09-16,106,4,33.69,3,1,3,7,1
KT-16465,2014-11-18,43,32,589.5894,5,10,5,20,7
KT-16480,2014-09-22,100,20,-156.15920000000006,3,6,2,11,3
KT-6465,2014-09-17,105,7,398.004,3,3,5,11,3
KT-6480,2014-08-10,143,7,-461.76,2,3,1,6,1
KW-16435,2014-11-20,41,23,3026.0406000000003,5,7,10,22,8
KW-16570,2014-11-09,52,34,2191.566300000002,5,10,9,24,9
KW-6435,2014-12-06,25,4,80.97000000000001,7,1,3,11,3
KW-6570,2014-11-13,48,6,179.57999999999998,5,2,4,11,3
LA-16780,2014-12-18,13,34,3754.0198000000028,8,10,10,28,10
LA-6780,2014-12-30,1,12,208.28999999999994,10,5,4,19,6
LB-16735,2014-12-22,9,29,1566.2419200000004,9,9,8,26,9
LB-16795,2014-11-22,39,31,4515.383220000001,6,10,10,26,9
LB-6735,2014-08-16,137,7,98.24999999999999,2,3,3,8,2
LB-6795,2014-09-19,103,8,-212.14499999999995,3,4,2,9,2
LC-16870,2014-09-24,98,21,1048.3472600000002,3,6,7,16,5
LC-16885,2014-12-15,16,29,1325.4753000000005,8,9,7,24,9
LC-16930,2014-12-11,20,26,1932.3449599999994,7,8,9,24,9
LC-16960,2014-12-29,2,22,1365.9816999999996,10,6,7,23,8
LC-17050,2014-12-27,4,23,1150.0478200000002,10,7,7,24,9
LC-17140,2014-12-18,13,30,1454.4069600000016,8,9,8,25,9
LC-6870,2014-09-18,104,8,128.421,3,4,3,10,3
LC-6885,2014-12-02,29,9,-152.96399999999994,6,5,2,13,4
LC-6930,2014-11-09,52,9,341.079,5,5,5,15,5
LC-6960,2014-06-23,191,8,54.73199999999995,2,4,3,9,2
LC-7050,2014-12-25,6,7,1697.5620000000006,9,3,8,20,7
LC-7140,2014-12-15,16,6,470.87999999999994,8,2,5,15,5
LD-16855,2014-11-19,42,30,1813.1926799999999,5,9,8,22,8
LD-17005,2014-12-11,20,27,1252.6420399999995,7,8,7,22,8
LD-6855,2014-12-10,21,8,-326.454,7,4,1,12,4
LD-7005,2014-11-18,43,6,-87.20399999999998,5,2,2,9,2
LE-16810,2014-12-17,14,24,1737.1186,8,7,8,23,8
LE-6810,2014-10-29,63,6,287.91,4,2,4,10,3
LF-17185,2014-12-11,20,22,-3700.1955000000003,7,6,1,14,4
LF-7185,2014-07-07,177,5,55.847999999999985,2,2,3,7,1
LH-16750,2014-12-19,12,22,597.0119000000001,8,6,6,20,7
LH-16900,2014-10-12,80,29,995.3979800000002,4,9,7,20,7
LH-17020,2014-11-20,41,18,1040.3469,5,6,7,18,6
LH-17155,2014-10-17,75,29,749.0710000000005,4,9,6,19,6
LH-6750,2014-08-28,125,5,44.18999999999998,3,2,3,8,2
LH-6900,2014-02-28,306,3,1.991999999999971,1,1,2,4,1
LH-7020,2014-03-11,295,3,297.73199999999997,1,1,4,6,1
LH-7155,2014-08-26,127,8,770.4600000000002,3,4,6,13,4
LL-16840,2014-09-30,92,26,264.5978599999998,3,8,4,15,5
LL-6840,2014-11-26,35,9,630.3420000000002,6,5,6,17,5
LM-17065,2014-09-18,104,18,393.47099999999995,3,6,5,14,4
LM-7065,2014-12-24,7,4,1474.68,9,1,8,18,6
LO-17170,2014-12-29,2,28,2319.7047999999995,10,9,9,28,10
LO-7170,2014-12-27,4,7,-530.985,10,3,1,14,4
LP-17080,2014-12-05,26,24,-261.9351999999999,7,7,1,15,5
LP-17095,2014-12-22,9,26,2003.3279999999995,9,8,9,26,9
LP-7080,2014-06-30,184,7,-3.641999999999996,2,3,2,7,1
LP-7095,2014-12-31,0,4,119.36999999999999,10,1,3,14,4
LR-16915,2014-08-21,132,26,3604.461960000002,2,8,10,20,7
LR-17035,2014-11-16,45,26,2165.698300000001,5,8,9,22,8
LR-6915,2013-02-15,684,3,-232.746,1,1,2,4,1
LR-7035,2014-12-08,23,9,283.43999999999994,7,5,4,16,5
LS-16945,2014-10-10,82,20,-86.50593999999997,4,6,2,12,4
LS-16975,2014-11-29,32,22,1737.8784,6,6,8,20,7
LS-17200,2014-12-16,15,24,1756.4422199999992,8,7,8,23,8
LS-17230,2014-12-27,4,24,1946.6966799999996,10,7,9,26,9
LS-17245,2014-11-27,34,24,1878.1804000000006,6,7,9,22,8
LS-6945,2014-12-25,6,12,18.65399999999999,9,5,2,16,5
LS-6975,2014-06-07,207,5,40.19400000000002,2,2,3,7,1
LS-7200,2013-12-13,383,4,-102.474,1,1,2,4,1
LS-7230,2014-09-23,99,10,-569.292,3,5,1,9,2
LS-7245,2014-05-28,217,6,-380.04900000000004,2,2,1,5,1
LT-16765,2014-12-25,6,30,3948.662940000001,9,9,10,28,10
LT-17110,2014-11-27,34,26,1382.2841600000004,6,8,7,21,7
LT-6765,2014-12-23,8,4,264.99,9,1,4,14,4
LT-7110,2014-10-15,77,6,1764.1440000000002,4,2,8,14,4
LW-16825,2014-11-09,52,20,982.0109400000005,5,6,7,18,6
LW-16990,2014-11-28,33,23,1335.3454,6,7,7,20,7
LW-17125,2014-11-20,41,16,518.0502000000002,5,6,5,16,5
LW-17215,2014-12-04,27,24,994.55854,7,7,7,21,7
LW-6825,2014-11-29,32,11,166.79399999999995,6,5,4,15,5
LW-6990,2014-12-17,14,11,151.58099999999996,8,5,3,16,5
LW-7125,2014-12-06,25,9,881.9909999999999,7,5,6,18,6
LW-7215,2014-08-21,132,5,-145.176,2,2,2,6,1
MA-17560,2014-10-28,64,24,784.0774799999996,4,7,6,17,5
MA-17995,2014-11-19,42,22,889.3185399999998,5,6,6,17,5
MA-7560,2014-05-13,232,4,-264.17400000000004,1,1,1,3,1
MA-7995,2014-12-15,16,11,213.35699999999997,8,5,4,17,5
MB-17305,2014-12-30,1,27,3481.4083199999995,10,8,10,28,10
MB-18085,2014-11-17,44,30,2236.3055799999993,5,9,9,23,8
MB-7305,2014-09-12,110,8,1140.9389999999996,3,4,7,14,4
MB-8085,2014-12-20,11,8,359.65799999999996,9,4,5,18,6
MC-17275,2014-11-17,44,34,1463.0788999999997,5,10,8,23,8
MC-17425,2014-10-27,65,30,3980.557480000002,4,9,10,23,8
MC-17575,2014-11-30,31,33,966.02936,6,10,7,23,8
MC-17590,2014-12-06,25,25,1337.6087800000005,7,7,7,21,7
MC-17605,2014-12-11,20,26,1296.2884999999997,7,8,7,22,8
MC-17635,2014-12-26,5,34,3529.4932,10,10,10,30,10
MC-17845,2014-12-30,1,31,1064.3074199999994,10,10,7,27,10
MC-18100,2014-12-05,26,33,130.70980000000003,7,10,3,20,7
MC-18130,2014-12-04,27,23,717.1615,7,7,6,20,7
MC-7275,2014-10-05,87,5,650.4029999999998,4,2,6,12,4
MC-7425,2014-11-26,35,5,-1129.299,6,2,1,9,2
MC-7575,2014-12-22,9,8,783.3179999999999,9,4,6,19,6
MC-7590,2014-01-29,336,3,569.58,1,1,5,7,1
MC-7605,2014-06-19,195,2,70.67999999999999,2,1,3,6,1
MC-7635,2013-07-03,546,4,113.79599999999999,1,1,3,5,1
MC-7845,2014-11-27,34,4,148.69800000000004,6,1,3,10,3
MC-8100,2014-09-18,104,3,205.44000000000003,3,1,4,8,2
MC-8130,2014-03-19,287,5,79.47000000000001,1,2,3,6,1
MD-17350,2014-12-06,25,30,1040.95532,7,9,7,23,8
MD-17860,2014-11-25,36,28,1596.30844,6,9,8,23,8
MD-7350,2014-10-10,82,6,189.678,4,2,4,10,3
MD-7860,2014-09-19,103,5,2176.0919999999987,3,2,9,14,4
ME-17320,2014-12-26,5,30,3359.6504999999997,10,9,10,29,10
ME-17725,2014-11-01,60,28,323.4762000000002,4,9,4,17,5
ME-18010,2014-11-19,42,27,639.3183200000004,5,8,6,19,6
ME-7320,2014-11-12,49,10,58.90800000000003,5,5,3,13,4
ME-7725,2014-12-20,11,11,349.78499999999997,9,5,5,19,6
ME-8010,2013-04-12,628,1,15.9,1,1,2,4,1
MF-17665,2014-11-06,55,29,1417.46584,5,9,8,22,8
MF-18250,2014-12-24,7,32,2272.4103999999993,9,10,9,28,10
MF-7665,2014-11-13,48,3,3.42,5,1,2,8,2
MF-8250,2014-10-30,62,6,300.92999999999995,4,2,4,10,3
MG-17650,2014-12-12,19,21,2178.1716799999995,7,6,9,22,8
MG-17680,2014-11-25,36,28,892.4347000000001,6,9,6,21,7
MG-17695,2014-12-31,0,25,760.9116000000004,10,7,6,23,8
MG-17875,2014-12-26,5,33,-133.48077999999998,10,10,2,22,8
MG-17890,2014-12-26,5,29,-977.2978999999999,10,9,1,20,7
MG-18145,2014-12-29,2,24,4668.1622,10,7,10,27,10
MG-18205,2014-12-29,2,29,1540.2313000000001,10,9,8,27,10
MG-7650,2013-08-23,495,1,27.15,1,1,3,5,1
MG-7680,2014-11-10,51,9,-151.24200000000002,5,5,2,12,4
MG-7695,2014-01-30,335,7,84.78599999999992,1,3,3,7,1
MG-7875,2013-11-23,403,1,15.87,1,1,2,4,1
MG-7890,2013-12-23,373,1,-22.482,1,1,2,4,1
MG-8145,2014-03-25,281,3,1790.514,1,1,8,10,3
MG-8205,2014-12-30,1,7,282.20399999999995,10,3,4,17,5
MH-17290,2014-12-03,28,25,1950.6128599999993,6,7,9,22,8
MH-17440,2014-12-23,8,25,771.4384,9,7,6,22,8
MH-17455,2014-08-14,139,27,155.8960200000001,2,8,3,13,4
MH-17620,2014-10-09,83,20,106.88497999999989,4,6,3,13,4
MH-17785,2014-12-31,0,26,1185.0254399999997,10,8,7,25,9
MH-18025,2014-12-11,20,19,1010.9377000000003,7,6,7,20,7
MH-18115,2014-12-26,5,26,1250.6666000000007,10,8,7,25,9
MH-7290,2012-12-24,737,3,365.4,1,1,5,7,1
MH-7440,2014-09-26,96,8,780.57,3,4,6,13,4
MH-7455,2014-09-30,92,10,371.151,3,5,5,13,4
MH-7620,2014-04-30,245,7,168.00599999999997,1,3,4,8,2
MH-7785,2014-12-24,7,9,285.504,9,5,4,18,6
MH-8025,2014-12-17,14,9,-149.75400000000002,8,5,2,15,5
MH-8115,2014-09-08,114,7,237.522,3,3,4,10,3
MJ-17740,2014-12-03,28,26,2054.661900000001,6,8,9,23,8
MJ-7740,2014-07-25,159,4,382.9680000000001,2,1,5,8,2
MK-17905,2014-10-29,63,31,-139.19500000000002,4,10,2,16,5
MK-18160,2014-11-28,33,20,317.5605999999999,6,6,4,16,5
MK-7905,2014-05-26,219,11,-71.44499999999998,2,5,2,9,2
MK-8160,2014-11-21,40,10,441.03600000000023,6,5,5,16,5
ML-17395,2014-12-31,0,25,1141.9726799999999,10,7,7,24,9
ML-17410,2014-12-11,20,30,1338.5887999999993,7,9,7,23,8
ML-17755,2014-12-30,1,28,1577.4215999999994,10,9,8,27,10
ML-18040,2014-12-24,7,19,1646.9332,9,6,8,23,8
ML-18265,2014-09-22,100,26,2037.5839599999995,3,8,9,20,7
ML-7395,2014-08-21,132,7,142.26000000000002,2,3,3,8,2
ML-7410,2014-07-15,169,3,-184.44599999999997,2,1,2,5,1
ML-7755,2014-10-07,85,7,260.34,4,3,4,11,3
ML-8040,2014-11-17,44,7,315.90599999999995,5,3,4,12,4
ML-8265,2014-12-23,8,9,276.78,9,5,4,18,6
MM-17260,2014-12-27,4,26,3160.3071199999986,10,8,10,28,10
MM-17920,2014-12-24,7,33,1824.2189999999996,9,10,8,27,10
MM-18055,2014-12-16,15,25,1901.2816999999995,8,7,9,24,9
MM-18280,2014-12-19,12,25,1877.0716000000002,8,7,9,24,9
MM-7260,2014-10-03,89,5,1220.418,3,2,7,12,4
MM-7920,2014-09-10,112,6,234.69000000000003,3,2,4,9,2
MM-8055,2014-11-28,33,8,-638.499,6,4,1,11,3
MM-8280,2014-11-08,53,10,289.395,5,5,4,14,4
MN-17935,2014-12-23,8,21,1517.1508199999996,9,6,8,23,8
MN-7935,2014-09-15,107,6,-124.98,3,2,2,7,1
MO-17500,2014-11-25,36,24,573.4589000000003,6,7,5,18,6
MO-17800,2014-12-25,6,25,2638.8095000000003,9,7,10,26,9
MO-17950,2014-12-25,6,14,34.126600000000025,9,5,3,17,5
MO-7500,2014-03-25,281,5,-54.45000000000004,1,2,2,5,1
MO-7800,2014-12-17,14,9,465.2760000000001,8,5,5,18,6
MO-7950,2014-09-24,98,3,252.132,3,1,4,8,2
MP-17470,2014-12-26,5,28,2231.3580999999995,10,9,9,28,10
MP-17965,2014-12-04,27,39,1455.212,7,10,8,25,9
MP-18175,2014-12-15,16,36,455.29570000000007,8,10,5,23,8
MP-7470,2013-06-07,572,2,-58.38,1,1,2,4,1
MP-7965,2014-06-18,196,8,177.48299999999998,2,4,4,10,3
MP-8175,2014-07-16,168,6,77.30400000000002,2,2,3,7,1
MR-17545,2014-11-03,58,23,3060.9206000000004,4,7,10,21,7
MR-7545,2014-09-22,100,6,650.3100000000002,3,2,6,11,3
MS-17365,2014-12-26,5,34,3300.322199999998,10,10,10,30,10
MS-17530,2014-12-16,15,25,2150.4531600000014,8,7,9,24,9
MS-17710,2014-11-28,33,26,1057.94306,6,8,7,21,7
MS-17770,2014-12-11,20,36,2685.675440000001,7,10,10,27,10
MS-17830,2014-10-29,63,26,1765.3904999999995,4,8,8,20,7
MS-17980,2014-12-06,25,27,834.6122000000007,7,8,6,21,7
MS-7365,2014-11-09,52,5,229.01999999999998,5,2,4,11,3
MS-7530,2014-10-11,81,8,-163.07399999999998,4,4,2,10,3
MS-7710,2014-10-29,63,8,94.8,4,4,3,11,3
MS-7770,2014-09-24,98,6,166.11,3,2,4,9,2
MS-7830,2014-12-27,4,8,294.8940000000002,10,4,4,18,6
MS-7980,2014-12-25,6,5,412.73400000000004,9,2,5,16,5
MT-17815,2014-12-11,20,27,1294.9966000000004,7,8,7,22,8
MT-18070,2014-11-06,55,24,1203.5737999999994,5,7,7,19,6
MT-7815,2014-09-06,116,6,-501.58200000000005,3,2,1,6,1
MT-8070,2014-11-02,59,7,-2991.6179999999995,4,3,1,8,2
MV-17485,2014-12-15,16,27,1650.8830999999993,8,8,8,24,9
MV-18190,2014-12-12,19,30,1178.6598000000001,7,9,7,23,8
MV-7485,2013-09-17,470,5,159.75600000000003,1,2,3,6,1
MV-8190,2014-12-24,7,8,181.3800000000002,9,4,4,17,5
MW-18220,2014-12-14,17,28,3596.313300000002,8,9,10,27,10
MW-18235,2014-12-15,16,24,-180.23909999999998,8,7,2,17,5
MW-8220,2014-11-17,44,8,490.2270000000001,5,4,5,14,4
MW-8235,2014-12-31,0,6,325.752,10,2,4,16,5
MY-17380,2014-11-25,36,28,2926.3333000000002,6,9,10,25,9
MY-18295,2014-12-31,0,29,2553.6770800000004,10,9,9,28,10
MY-7380,2014-12-02,29,4,633.1739999999999,6,1,6,13,4
MY-8295,2014-11-18,43,10,88.97699999999999,5,5,3,13,4
MZ-17335,2014-12-05,26,26,1794.5973999999999,7,8,8,23,8
MZ-17515,2014-11-18,43,25,1454.6211399999997,5,7,8,20,7
MZ-7335,2014-11-02,59,5,459.90599999999995,4,2,5,11,3
MZ-7515,2014-10-14,78,9,428.421,4,5,5,14,4
NB-18580,2013-09-27,460,10,-105.25479999999999,1,5,2,8,2
NB-18655,2014-12-12,19,22,1537.0685000000003,7,6,8,21,7
NB-8580,2013-10-29,428,7,-586.173,1,3,1,5,1
NB-8655,2014-12-09,22,5,-83.66400000000002,7,2,2,11,3
NC-18340,2014-12-26,5,22,-996.2393800000001,10,6,1,17,5
NC-18415,2014-11-22,39,19,-771.6432,6,6,1,13,4
NC-18535,2014-12-25,6,22,1414.9770000000005,9,6,8,23,8
NC-18625,2014-11-12,49,29,2229.91458,5,9,9,23,8
NC-8340,2014-11-26,35,9,535.3620000000001,6,5,5,16,5
NC-8415,2014-09-16,106,5,46.655999999999985,3,2,3,8,2
NC-8535,2014-08-15,138,7,-79.59899999999999,2,3,2,7,1
NC-8625,2013-09-26,461,2,33.0,1,1,3,5,1
ND-18370,2014-12-19,12,23,1970.2773199999997,8,7,9,24,9
ND-18460,2014-12-26,5,22,2197.4235200000016,10,6,9,25,9
ND-8370,2014-11-28,33,6,650.004,6,2,6,14,4
ND-8460,2014-12-23,8,10,971.4299999999998,9,5,7,21,7
NF-18385,2014-12-24,7,32,1362.2721000000004,9,10,7,26,9
NF-18475,2014-12-25,6,22,2633.7607000000003,9,6,10,25,9
NF-18595,2014-12-20,11,22,1438.9526199999996,9,6,8,23,8
NF-8385,2014-12-30,1,11,180.54899999999998,10,5,4,19,6
NF-8475,2014-11-18,43,7,286.296,5,3,4,12,4
NF-8595,2013-10-07,450,5,-67.404,1,2,2,5,1
NG-18355,2014-12-09,22,21,1826.7028599999999,7,6,8,21,7
NG-18430,2014-11-14,47,28,3320.695839999999,5,9,10,24,9
NG-8355,2014-09-19,103,7,979.7399999999999,3,3,7,13,4
NG-8430,2014-12-13,18,8,890.5289999999999,8,4,6,18,6
NH-18610,2014-12-09,22,22,3867.6129,7,6,10,23,8
NH-8610,2014-12-26,5,6,207.85199999999998,10,2,4,16,5
NK-18490,2014-10-22,70,24,2309.4927,4,7,9,20,7
NK-8490,2014-08-06,147,4,731.0400000000001,2,1,6,9,2
NL-18310,2014-10-31,61,25,-593.2810999999997,4,7,1,12,4
NL-8310,2013-04-06,634,2,26.352000000000004,1,1,3,5,1
NM-18445,2014-11-03,58,32,5095.156799999999,4,10,10,24,9
NM-18520,2014-12-12,19,27,2631.0495,7,8,10,25,9
NM-8445,2014-11-28,33,9,693.9599999999999,6,5,6,17,5
NM-8520,2014-07-26,158,1,511.65,2,1,5,8,2
NP-18325,2014-12-30,1,25,1772.79,10,7,8,25,9
NP-18670,2014-10-30,62,19,2741.602459999999,4,6,10,20,7
NP-18685,2014-12-17,14,30,308.26689999999996,8,9,4,21,7
NP-18700,2014-12-06,25,27,609.6892000000003,7,8,6,21,7
NP-8325,2014-12-16,15,8,31.53599999999998,8,4,3,15,5
NP-8670,2014-05-19,226,6,294.06,2,2,4,8,2
NP-8685,2014-08-09,144,4,1250.76,2,1,7,10,3
NP-8700,2014-11-24,37,6,-234.1379999999999,6,2,2,10,3
NR-18550,2014-12-29,2,26,1206.9247799999994,10,8,7,25,9
NR-8550,2014-12-17,14,8,463.041,8,4,5,17,5
NS-18505,2014-12-25,6,25,479.1027400000003,9,7,5,21,7
NS-18640,2014-11-25,36,37,1116.0526000000007,6,10,7,23,8
NS-8505,2014-12-18,13,5,-1166.5470000000003,8,2,1,11,3
NS-8640,2014-12-04,27,8,-297.3330000000001,7,4,1,12,4
NW-18400,2014-12-07,24,26,2085.4920599999996,7,8,9,24,9
NW-8400,2014-09-08,114,7,1736.046,3,3,8,14,4
NZ-18565,2014-09-13,109,26,2257.8417200000004,3,8,9,20,7
NZ-8565,2014-09-23,99,4,-166.56599999999997,3,1,2,6,1
ON-18715,2014-11-14,47,33,3779.1692399999997,5,10,10,25,9
ON-8715,2013-09-28,459,5,-995.862,1,2,1,4,1
OT-18730,2014-11-28,33,32,1797.7613599999995,6,10,8,24,9
OT-8730,2014-03-05,301,4,33.239999999999995,1,1,3,5,1
PA-19060,2014-11-11,50,21,647.8935600000002,5,6,6,17,5
PA-9060,2014-07-07,177,6,907.4609999999999,2,2,6,10,3
PB-18805,2014-12-23,8,19,1479.5774399999998,9,6,8,23,8
PB-19105,2014-09-23,99,16,1615.6466999999998,3,6,8,17,5
PB-19150,2014-12-26,5,33,460.19616,10,10,5,25,9
PB-19210,2014-12-23,8,27,2313.680999999999,9,8,9,26,9
PB-8805,2014-02-09,325,9,263.50199999999995,1,5,4,10,3
PB-9105,2014-12-31,0,4,320.538,10,1,4,15,5
PB-9150,2014-11-20,41,10,811.6529999999998,5,5,6,16,5
PB-9210,2014-02-27,307,7,-909.7230000000001,1,3,1,5,1
PC-18745,2014-12-29,2,21,-904.3325600000005,10,6,1,17,5
PC-19000,2014-12-03,28,18,519.6209,6,6,5,17,5
PC-8745,2014-04-11,264,5,484.23,1,2,5,8,2
PC-9000,2013-07-06,543,4,313.7099999999999,1,1,4,6,1
PF-19120,2014-09-29,93,28,623.4013599999998,3,9,6,18,6
PF-19165,2014-12-02,29,36,1486.3466000000005,6,10,8,24,9
PF-19225,2014-12-29,2,30,1613.6235,10,9,8,27,10
PF-9120,2014-09-10,112,10,439.8900000000001,3,5,5,13,4
PF-9165,2014-11-27,34,7,422.532,6,3,5,14,4
PF-9225,2014-12-17,14,7,-672.7679999999999,8,3,1,12,4
PG-18820,2014-12-11,20,35,1626.9189000000003,7,10,8,25,9
PG-18895,2014-12-29,2,28,1270.0985,10,9,7,26,9
PG-8820,2014-12-02,29,6,348.27,6,2,5,13,4
PG-8895,2014-07-03,181,6,350.08199999999994,2,2,5,9,2
PH-18790,2014-10-22,70,19,2390.076100000001,4,6,9,19,6
PH-8790,2014-08-09,144,8,353.54999999999995,2,4,5,11,3
PJ-18835,2014-11-22,39,19,4889.267499999998,6,6,10,22,8
PJ-19015,2014-12-12,19,22,1212.813060000001,7,6,7,20,7
PJ-8835,2014-11-19,42,6,-870.1349999999998,5,2,1,8,2
PJ-9015,2014-06-18,196,8,889.6799999999998,2,4,6,12,4
PK-18910,2014-09-24,98,16,319.16456,3,6,4,13,4
PK-19075,2014-12-23,8,29,2170.2641000000012,9,9,9,27,10
PK-8910,2014-05-14,231,4,-627.654,1,1,1,3,1
PK-9075,2013-08-24,494,3,-505.68599999999986,1,1,1,3,1
PL-18925,2014-12-16,15,20,1782.9748999999997,8,6,8,22,8
PL-8925,2014-12-11,20,3,223.53000000000003,7,1,4,12,4
PM-18940,2014-11-20,41,23,926.3291999999994,5,7,6,18,6
PM-19135,2014-12-19,12,22,648.8515999999998,8,6,6,20,7
PM-8940,2014-06-11,203,9,252.06599999999997,2,5,4,11,3
PM-9135,2014-05-03,242,6,369.786,1,2,5,8,2
PN-18775,2014-12-16,15,33,1729.7528199999995,8,10,8,26,9
PN-8775,2014-08-11,142,5,475.7099999999999,2,2,5,9,2
PO-18850,2014-12-27,4,41,3249.277699999999,10,10,10,30,10
PO-18865,2014-12-31,0,35,4698.639099999999,10,10,10,30,10
PO-19180,2014-07-24,160,24,2556.741599999999,2,7,9,18,6
PO-19195,2014-07-03,181,21,-1667.6880200000005,2,6,1,9,2
PO-8850,2014-08-26,127,4,529.0859999999999,3,1,5,9,2
PO-8865,2014-01-13,352,6,-80.52000000000005,1,2,2,5,1
PO-9180,2014-02-12,322,9,-380.9519999999998,1,5,1,7,1
PO-9195,2014-11-28,33,8,641.5860000000002,6,4,6,16,5
PP-18955,2014-10-29,63,30,2902.391999999999,4,9,10,23,8
PP-8955,2014-12-17,14,3,-214.659,8,1,2,11,3
PR-18880,2014-11-25,36,29,1362.82542,6,9,7,22,8
PR-8880,2014-06-18,196,5,-953.7000000000002,2,2,1,5,1
PS-18760,2014-11-26,35,28,1485.3093999999999,6,9,8,23,8
PS-18970,2014-11-29,32,33,2205.4257199999997,6,10,9,25,9
PS-19045,2014-11-27,34,26,4426.195099999999,6,8,10,24,9
PS-8760,2014-01-18,347,5,-192.19799999999992,1,2,2,5,1
PS-8970,2014-08-29,124,4,-371.23199999999997,3,1,1,5,1
PS-9045,2014-10-31,61,7,-87.38400000000003,4,3,2,9,2
PT-19090,2014-12-25,6,25,216.67020000000002,9,7,4,20,7
PT-9090,2014-12-29,2,5,393.03000000000003,10,2,5,17,5
PV-18985,2014-12-23,8,28,2531.1434000000004,9,9,9,27,10
PV-8985,2014-12-06,25,6,1524.4260000000002,7,2,8,17,5
PW-19030,2014-12-24,7,31,2322.3993600000003,9,10,9,28,10
PW-19240,2014-12-30,1,24,1837.4187999999997,10,7,8,25,9
PW-9030,2014-11-04,57,7,-377.59799999999996,4,3,1,8,2
PW-9240,2014-10-31,61,7,104.87999999999998,4,3,3,10,3
QJ-19255,2014-11-06,55,23,2407.601900000001,5,7,9,21,7
QJ-9255,2014-10-31,61,5,-164.40899999999996,4,2,2,8,2
RA-19285,2014-12-26,5,24,4132.8992,10,7,10,27,10
RA-19885,2014-11-18,43,23,3419.9606799999992,5,7,10,22,8
RA-19915,2014-12-19,12,27,2078.7577199999996,8,8,9,25,9
RA-19945,2014-12-30,1,23,678.9608,10,7,6,23,8
RA-9285,2014-04-21,254,14,-1519.8240000000003,1,5,1,7,1
RA-9885,2014-10-04,88,8,-99.492,3,4,2,9,2
RA-9915,2014-08-14,139,2,85.44,2,1,3,6,1
RA-9945,2014-11-12,49,9,217.76700000000008,5,5,4,14,4
RB-19330,2014-12-16,15,32,3737.586419999998,8,10,10,28,10
RB-19360,2014-11-12,49,25,8523.951500000003,5,7,10,22,8
RB-19435,2014-12-12,19,28,605.4394200000004,7,9,6,22,8
RB-19465,2014-12-31,0,36,2769.6499999999983,10,10,10,30,10
RB-19570,2014-11-25,36,25,1646.1129,6,7,8,21,7
RB-19645,2014-08-03,150,22,754.2794000000002,2,6,6,14,4
RB-19705,2014-12-15,16,16,2069.0791,8,6,9,23,8
RB-19795,2014-11-29,32,35,2323.662140000001,6,10,9,25,9
RB-9330,2014-10-09,83,8,413.76599999999996,4,4,5,13,4
RB-9360,2014-09-29,93,4,-70.90199999999999,3,1,2,6,1
RB-9435,2014-05-29,216,6,-1731.0960000000002,2,2,1,5,1
RB-9465,2014-03-19,287,3,1296.81,1,1,7,9,2
RB-9570,2013-11-10,416,5,-150.18900000000002,1,2,2,5,1
RB-9645,2014-06-05,209,3,-114.156,2,1,2,5,1
RB-9705,2014-04-28,247,12,810.4619999999999,1,5,6,12,4
RB-9795,2014-09-07,115,5,26.868000000000002,3,2,3,8,2
RC-19825,2014-05-05,240,25,737.7456999999998,1,7,6,14,4
RC-19960,2014-12-09,22,22,1758.0904000000005,7,6,8,21,7
RC-9825,2012-12-20,741,1,0.0,1,1,2,4,1
RC-9960,2014-10-09,83,5,365.925,4,2,5,11,3
RD-19480,2014-12-31,0,27,3316.9349,10,8,10,28,10
RD-19585,2014-12-08,23,31,2450.5696999999996,7,10,9,26,9
RD-19660,2014-11-02,59,21,3171.695100000001,4,6,10,20,7
RD-19720,2014-11-14,47,30,1897.1189000000004,5,9,9,23,8
RD-19810,2014-12-17,14,30,1417.2764600000003,8,9,8,25,9
RD-19900,2014-11-29,32,29,2475.0832,6,9,9,24,9
RD-19930,2014-11-19,42,22,683.3937199999998,5,6,6,17,5
RD-9480,2014-11-14,47,6,270.51,5,2,4,11,3
RD-9585,2014-12-09,22,7,1469.3999999999994,7,3,8,18,6
RD-9660,2014-06-10,204,9,794.178,2,5,6,13,4
RD-9720,2014-10-22,70,8,1139.892,4,4,7,15,5
RD-9810,2014-08-11,142,7,522.618,2,3,5,10,3
RD-9900,2014-09-30,92,10,855.5910000000001,3,5,6,14,4
RD-9930,2014-09-19,103,11,546.9720000000004,3,5,5,13,4
RE-19405,2014-12-11,20,21,2356.0071799999996,7,6,9,22,8
RE-19450,2014-08-12,141,18,1501.18864,2,6,8,16,5
RE-9405,2014-10-21,71,6,287.673,4,2,4,10,3
RE-9450,2014-12-16,15,12,890.2230000000001,8,5,6,19,6
RF-19345,2014-10-28,64,27,2277.379,4,8,9,21,7
RF-19735,2014-12-30,1,23,824.7585000000001,10,7,6,23,8
RF-19840,2014-12-25,6,31,3052.1697799999997,9,10,10,29,10
RF-9345,2014-12-25,6,5,816.576,9,2,6,17,5
RF-9735,2014-05-06,239,3,298.77,1,1,4,6,1
RF-9840,2014-08-15,138,6,-210.438,2,2,2,6,1
RH-19495,2014-12-01,30,28,1457.3803,6,9,8,23,8
RH-19510,2014-11-12,49,25,1800.9964600000003,5,7,8,20,7
RH-19555,2014-12-24,7,21,293.00469999999973,9,6,4,19,6
RH-19600,2014-12-25,6,21,329.75165999999996,9,6,4,19,6
RH-9495,2014-09-26,96,3,393.51,3,1,5,9,2
RH-9510,2013-01-30,700,7,-136.33200000000002,1,3,2,6,1
RH-9555,2014-06-11,203,8,1709.7989999999998,2,4,8,14,4
RH-9600,2014-11-07,54,8,892.62,5,4,6,15,5
RK-19300,2014-08-26,127,26,-1673.56942,3,8,1,12,4
RK-9300,2014-10-28,64,4,117.78,4,1,3,8,2
RL-19615,2014-08-29,124,23,2337.1428800000003,3,7,9,19,6
RL-9615,2014-10-04,88,8,366.8459999999999,3,4,5,12,4
RM-19375,2014-12-13,18,25,1331.50702,8,7,7,22,8
RM-19675,2014-12-27,4,19,2810.5083,10,6,10,26,9
RM-19750,2014-12-15,16,19,1314.8787600000005,8,6,7,21,7
RM-9375,2014-12-22,9,7,523.896,9,3,5,17,5
RM-9675,2014-12-08,23,8,-268.266,7,4,1,12,4
RM-9750,2014-12-08,23,7,-64.54499999999999,7,3,2,12,4
RO-19780,2014-11-26,35,29,710.6859,6,9,6,21,7
RO-9780,2014-12-27,4,9,158.19600000000003,10,5,3,18,6
RP-19270,2014-12-24,7,26,1507.9101000000005,9,8,8,25,9
RP-19390,2014-12-16,15,34,-452.0761999999999,8,10,1,19,6
RP-19855,2014-11-29,32,27,428.40520000000015,6,8,5,19,6
RP-9270,2014-03-20,286,6,394.81199999999995,1,2,5,8,2
RP-9390,2014-05-04,241,7,1520.46,1,3,8,12,4
RP-9855,2013-11-26,400,6,-289.55099999999993,1,2,1,4,1
RR-19315,2014-12-12,19,21,2304.3833799999998,7,6,9,22,8
RR-19525,2014-12-31,0,27,-99.16279999999983,10,8,2,20,7
RR-9315,2014-05-13,232,4,534.6,1,1,5,7,1
RR-9525,2014-06-27,187,7,51.18,2,3,3,8,2
RS-19420,2014-10-16,76,28,1771.0308799999996,4,9,8,21,7
RS-19765,2014-11-25,36,25,3046.3163799999998,6,7,10,23,8
RS-19870,2014-12-12,19,20,1222.8525799999993,7,6,7,20,7
RS-9420,2014-12-06,25,7,52.61999999999999,7,3,3,13,4
RS-9765,2014-08-30,123,6,425.84999999999997,3,2,5,10,3
RS-9870,2014-11-12,49,8,240.57600000000005,5,4,4,13,4
RW-19540,2014-11-19,42,25,3925.024800000001,5,7,10,22,8
RW-19630,2014-11-04,57,26,1999.6208000000001,4,8,9,21,7
RW-19690,2014-12-16,15,25,2312.2563000000005,8,7,9,24,9
RW-9540,2014-09-22,100,7,1252.4040000000002,3,3,7,13,4
RW-9630,2013-11-27,399,2,252.6,1,1,4,6,1
RW-9690,2014-11-09,52,8,-175.254,5,4,2,11,3
SA-10830,2014-12-21,10,10,-56.54399999999999,9,5,2,16,5
SA-20830,2014-10-29,63,30,1411.24676,4,9,7,20,7
SB-10170,2014-09-09,113,5,24.06000000000002,3,2,2,7,1
SB-10185,2014-10-14,78,7,223.296,4,3,4,11,3
SB-10290,2014-10-06,86,5,-120.66600000000001,4,2,2,8,2
SB-20170,2014-12-29,2,15,2342.8997999999997,10,6,9,25,9
SB-20185,2014-11-01,60,31,1445.35812,4,10,8,22,8
SB-20290,2014-11-20,41,22,-1776.3133,5,6,1,12,4
SC-10020,2014-11-04,57,4,-115.506,4,1,2,7,1
SC-10050,2014-11-19,42,7,358.854,5,3,5,13,4
SC-10095,2014-05-20,225,7,99.16199999999996,2,3,3,8,2
SC-10230,2014-06-20,194,3,286.317,2,1,4,7,1
SC-10260,2014-12-08,23,7,-42.882000000000005,7,3,2,12,4
SC-10305,2014-12-15,16,7,-213.14999999999998,8,3,2,13,4
SC-10380,2014-03-31,275,4,410.13,1,1,5,7,1
SC-10440,2014-09-30,92,4,-533.4390000000001,3,1,1,5,1
SC-10575,2013-12-23,373,2,41.64,1,1,3,5,1
SC-10680,2014-06-25,189,4,543.3599999999998,2,1,5,8,2
SC-10695,2014-10-07,85,4,-350.48100000000005,4,1,1,6,1
SC-10725,2014-08-15,138,7,191.214,2,3,4,9,2
SC-10770,2014-06-30,184,7,-127.66199999999996,2,3,2,7,1
SC-10800,2014-06-01,213,2,-77.844,2,1,2,5,1
SC-10845,2014-08-11,142,4,261.66,2,1,4,7,1
SC-20020,2014-12-23,8,34,1231.5156,9,10,7,26,9
SC-20050,2014-12-04,27,30,-340.4286799999997,7,9,1,17,5
SC-20095,2014-10-17,75,28,8106.2179,4,9,10,23,8
SC-20230,2014-12-15,16,25,2785.0509999999995,8,7,10,25,9
SC-20260,2014-12-31,0,26,1265.552800000001,10,8,7,25,9
SC-20305,2014-11-06,55,26,675.4286999999999,5,8,6,19,6
SC-20380,2014-11-03,58,37,1282.2497400000004,4,10,7,21,7
SC-20440,2014-12-22,9,25,890.4583599999999,9,7,6,22,8
SC-20575,2014-12-03,28,33,896.3616000000001,6,10,6,22,8
SC-20680,2014-11-26,35,31,1165.4330800000005,6,10,7,23,8
SC-20695,2014-12-22,9,35,2516.1646,9,10,9,28,10
SC-20725,2014-12-24,7,30,1874.82538,9,9,9,27,10
SC-20770,2014-11-21,40,32,445.74968000000024,6,10,5,21,7
SC-20800,2014-12-06,25,24,1354.1978,7,7,7,21,7
SC-20845,2014-12-23,8,24,1435.0387200000002,9,7,8,24,9
SD-10485,2014-11-21,40,8,216.303,6,4,4,14,4
SD-20485,2014-12-16,15,32,3430.9181000000026,8,10,10,28,10
SE-10110,2014-10-14,78,3,152.16000000000003,4,1,3,8,2
SE-20110,2014-12-22,9,36,5863.623920000001,9,10,10,29,10
SF-10065,2014-05-16,229,8,792.0089999999999,2,4,6,12,4
SF-10200,2014-12-08,23,8,-1384.404,7,4,1,12,4
SF-10965,2014-11-06,55,6,656.352,5,2,6,13,4
SF-20065,2014-10-30,62,21,1073.6423000000002,4,6,7,17,5
SF-20200,2014-12-26,5,28,2214.1680000000006,10,9,9,28,10
SF-20965,2014-12-08,23,17,1238.8309999999997,7,6,7,20,7
SG-10080,2013-12-27,369,6,331.90799999999996,1,2,4,7,1
SG-10470,2014-08-25,128,3,867.66,3,1,6,10,3
SG-10605,2014-12-05,26,6,211.497,7,2,4,13,4
SG-10890,2013-11-26,400,6,301.008,1,2,4,7,1
SG-20080,2014-12-28,3,17,2551.800400000001,10,6,9,25,9
SG-20470,2014-11-03,58,28,1471.3288,4,9,8,21,7
SG-20605,2014-10-17,75,32,1329.6055600000007,4,10,7,21,7
SG-20890,2014-12-15,16,22,240.30056000000002,8,6,4,18,6
SH-10395,2014-10-29,63,4,-52.83,4,1,2,7,1
SH-10635,2014-07-26,158,4,129.86999999999998,2,1,3,6,1
SH-19975,2014-10-28,64,29,987.2244400000001,4,9,7,20,7
SH-20395,2014-11-22,39,33,1112.0629399999996,6,10,7,23,8
SH-20635,2014-11-29,32,25,1848.3096000000003,6,7,9,22,8
SH-9975,2014-10-28,64,8,808.1370000000001,4,4,6,14,4
SJ-10125,2014-12-03,28,9,364.6290000000001,6,5,5,16,5
SJ-10215,2014-11-08,53,9,179.05200000000002,5,5,4,14,4
SJ-10500,2014-01-04,361,3,34.578,1,1,3,5,1
SJ-20125,2014-12-08,23,30,1463.3748999999993,7,9,8,24,9
SJ-20215,2014-10-10,82,32,2332.8089799999993,4,10,9,23,8
SJ-20500,2014-09-07,115,26,1547.2313,3,8,8,19,6
SK-19990,2014-12-23,8,19,2320.055819999999,9,6,9,24,9
SK-9990,2014-01-13,352,7,655.4580000000001,1,3,6,10,3
SL-10155,2014-07-18,166,14,655.7399999999997,2,5,6,13,4
SL-20155,2014-11-27,34,32,1244.1905000000002,6,10,7,23,8
SM-10005,2014-09-18,104,8,1177.8899999999999,3,4,7,14,4
SM-10320,2014-10-16,76,7,673.968,4,3,6,13,4
SM-10905,2014-08-21,132,5,247.78200000000007,2,2,4,8,2
SM-10950,2014-09-18,104,9,161.418,3,5,4,12,4
SM-20005,2014-06-08,206,22,350.47080000000017,2,6,5,13,4
SM-20320,2014-10-19,73,21,-1083.6743399999996,4,6,1,11,3
SM-20905,2014-11-24,37,17,1280.4928999999997,6,6,7,19,6
SM-20950,2014-11-28,33,29,1009.44034,6,9,7,22,8
SN-10560,2014-12-18,13,6,-110.85599999999998,8,2,2,12,4
SN-10710,2014-04-23,252,4,89.39999999999996,1,1,3,5,1
SN-20560,2014-11-09,52,25,-2527.124499999999,5,7,1,13,4
SN-20710,2014-11-17,44,24,2295.4512599999985,5,7,9,21,7
SO-10335,2013-11-26,400,4,17.417999999999992,1,1,2,4,1
SO-20335,2014-10-28,64,27,2389.6256200000003,4,8,9,21,7
SP-10545,2014-12-13,18,4,51.089999999999996,8,1,3,12,4
SP-10620,2014-08-14,139,5,-225.01200000000003,2,2,2,6,1
SP-10650,2014-07-15,169,6,-56.47500000000001,2,2,2,6,1
SP-10860,2013-11-28,398,2,62.13600000000001,1,1,3,5,1
SP-10920,2014-09-15,107,4,-165.219,3,1,2,6,1
SP-20545,2014-12-15,16,20,698.1370000000003,8,6,6,20,7
SP-20620,2014-12-26,5,31,242.05350000000016,10,10,4,24,9
SP-20650,2014-12-07,24,24,1739.2806400000002,7,7,8,22,8
SP-20860,2014-10-13,79,26,1688.5450600000008,4,8,8,20,7
SP-20920,2014-12-25,6,28,6649.62626,9,9,10,28,10
SR-10425,2014-11-17,44,5,-6.4620000000000015,5,2,2,9,2
SR-10740,2014-10-12,80,4,291.27,4,1,4,9,2
SR-20425,2014-12-23,8,19,-2544.7264600000008,9,6,1,16,5
SR-20740,2014-10-30,62,33,4096.088400000001,4,10,10,24,9
SS-10140,2014-04-07,268,7,905.3879999999998,1,3,6,10,3
SS-10410,2014-08-22,131,10,318.63,2,5,4,11,3
SS-10515,2013-02-25,674,3,130.38,1,1,3,5,1
SS-10590,2014-03-12,294,3,354.18,1,1,5,7,1
SS-10875,2014-04-25,250,4,-707.826,1,1,1,3,1
SS-20140,2014-12-16,15,32,-1517.7162599999983,8,10,1,19,6
SS-20410,2014-12-09,22,27,-187.1188199999999,7,8,2,17,5
SS-20515,2014-12-31,0,19,285.96612000000005,10,6,4,20,7
SS-20590,2014-12-26,5,26,2015.9465000000002,10,8,9,27,10
SS-20875,2014-12-17,14,21,147.84879999999995,8,6,3,17,5
ST-10530,2014-11-06,55,6,159.54000000000002,5,2,3,10,3
ST-20530,2014-12-25,6,32,2074.56296,9,10,9,28,10
SU-10665,2014-11-13,48,6,564.6839999999999,5,2,5,12,4
SU-20665,2014-12-27,4,23,-54.43209999999997,10,7,2,19,6
SV-10365,2014-01-07,358,5,258.25200000000007,1,2,4,7,1
SV-10785,2014-10-17,75,7,260.85,4,3,4,11,3
SV-10815,2014-12-23,8,9,-537.138,9,5,1,15,5
SV-10935,2014-12-20,11,3,-331.69399999999996,9,1,1,11,3
SV-20365,2014-09-21,101,31,1964.5016800000008,3,10,9,22,8
SV-20785,2014-09-12,110,27,1921.9372999999998,3,8,9,20,7
SV-20815,2014-12-03,28,24,1515.8113800000003,6,7,8,21,7
SV-20935,2014-12-31,0,28,1000.1729000000004,10,9,7,26,9
SW-10245,2014-09-12,110,4,325.59000000000003,3,1,4,8,2
SW-10275,2014-12-11,20,5,159.258,7,2,3,12,4
SW-10350,2014-09-22,100,9,-4.895999999999997,3,5,2,10,3
SW-10455,2014-12-24,7,9,399.372,9,5,5,19,6
SW-10755,2014-11-18,43,7,499.02599999999995,5,3,5,13,4
SW-20245,2014-12-19,12,26,1622.7696199999996,8,8,8,24,9
SW-20275,2014-11-30,31,33,884.9291999999998,6,10,6,22,8
SW-20350,2014-12-19,12,21,1036.4437400000002,8,6,7,21,7
SW-20455,2014-12-24,7,22,764.1969999999994,9,6,6,21,7
SW-20755,2014-12-16,15,31,2295.7056000000002,8,10,9,27,10
SZ-10035,2012-05-19,956,4,130.61999999999998,1,1,3,5,1
SZ-20035,2014-12-18,13,37,2785.2273000000005,8,10,10,28,10
TA-11385,2014-12-23,8,5,36.99000000000014,9,2,3,14,4
TA-21385,2014-12-13,18,25,6274.989100000002,8,7,10,25,9
TB-11055,2014-10-02,90,3,533.0579999999999,3,1,5,9,2
TB-11175,2014-05-29,216,4,175.356,2,1,4,7,1
TB-11190,2014-08-09,144,4,179.49,2,1,4,7,1
TB-11250,2014-12-30,1,15,656.016,10,6,6,22,8
TB-11280,2014-07-28,156,9,193.032,2,5,4,11,3
TB-11355,2014-12-17,14,8,-321.9779999999999,8,4,1,13,4
TB-11400,2014-11-09,52,9,724.5930000000002,5,5,6,16,5
TB-11520,2014-12-13,18,11,455.4509999999999,8,5,5,18,6
TB-11595,2014-10-03,89,4,219.63000000000002,3,1,4,8,2
TB-11625,2013-11-28,398,5,-366.858,1,2,1,4,1
TB-21055,2014-11-26,35,29,1026.2110199999997,6,9,7,22,8
TB-21175,2014-12-11,20,27,2111.0459000000005,7,8,9,24,9
TB-21190,2014-12-11,20,17,1872.8213200000005,7,6,9,22,8
TB-21250,2014-12-29,2,28,2409.6902,10,9,9,28,10
TB-21280,2014-10-21,71,26,1054.4293599999999,4,8,7,19,6
TB-21355,2014-10-10,82,20,1093.9919999999995,4,6,7,17,5
TB-21400,2014-12-06,25,26,3471.7569000000003,7,8,10,25,9
TB-21520,2014-10-09,83,34,-198.08937999999995,4,10,2,16,5
TB-21595,2014-12-11,20,26,1219.0208999999998,7,8,7,22,8
TB-21625,2014-12-11,20,31,1867.5211000000004,7,10,9,26,9
TC-10980,2014-11-14,47,8,-114.57599999999994,5,4,2,11,3
TC-11145,2014-12-19,12,10,1228.8060000000003,8,5,7,20,7
TC-11295,2014-12-19,12,5,233.92799999999997,8,2,4,14,4
TC-11475,2014-10-06,86,9,219.86400000000003,4,5,4,13,4
TC-11535,2013-12-26,370,4,-1355.658,1,1,1,3,1
TC-20980,2014-11-08,53,28,8787.474900000005,5,9,10,24,9
TC-21145,2014-12-20,11,25,2131.0062599999987,9,7,9,25,9
TC-21295,2014-12-08,23,29,1263.5488,7,9,7,23,8
TC-21475,2014-12-30,1,29,1181.2645600000003,10,9,7,26,9
TC-21535,2014-12-31,0,30,1738.6551000000004,10,9,8,27,10
TD-10995,2014-05-03,242,3,-769.8120000000001,1,1,1,3,1
TD-20995,2014-12-31,0,25,-178.31079999999974,10,7,2,19,6
TG-11310,2014-08-04,149,3,243.537,2,1,4,7,1
TG-11640,2014-11-21,40,9,1106.253,6,5,7,18,6
TG-21310,2014-12-17,14,32,2742.92,8,10,10,28,10
TG-21640,2014-12-26,5,33,1989.9868000000006,10,10,9,29,10
TH-11100,2014-04-22,253,4,364.71000000000004,1,1,5,7,1
TH-11115,2014-10-02,90,6,490.34999999999997,3,2,5,10,3
TH-11235,2014-05-15,230,10,549.5669999999997,1,5,5,11,3
TH-11550,2013-09-25,462,5,-24.209999999999997,1,2,2,5,1
TH-21100,2014-12-25,6,27,1587.7861000000003,9,8,8,25,9
TH-21115,2014-11-18,43,25,1775.3377800000003,5,7,8,20,7
TH-21235,2014-12-23,8,26,1106.7199999999998,9,8,7,24,9
TH-21550,2014-12-26,5,26,-709.5374999999998,10,8,1,19,6
TM-11010,2014-03-05,301,3,-270.504,1,1,1,3,1
TM-11490,2014-09-20,102,8,-877.5479999999997,3,4,1,8,2
TM-21010,2014-10-28,64,27,2198.637899999999,4,8,9,21,7
TM-21490,2014-12-05,26,27,2378.519300000001,7,8,9,24,9
TN-11040,2014-07-11,173,2,26.310000000000002,2,1,3,6,1
TN-21040,2014-12-05,26,29,-732.4921599999999,7,9,1,17,5
TP-11130,2014-08-14,139,6,109.47900000000003,2,2,3,7,1
TP-11415,2013-03-30,641,4,467.1479999999999,1,1,5,7,1
TP-11565,2014-09-19,103,5,145.17000000000002,3,2,3,8,2
TP-21130,2014-12-29,2,37,1964.40738,10,10,9,29,10
TP-21415,2014-11-13,48,22,-120.96078000000006,5,6,2,13,4
TP-21565,2014-12-17,14,30,1650.4900000000005,8,9,8,25,9
TR-11325,2014-07-16,168,4,669.8760000000001,2,1,6,9,2
TR-21325,2014-12-30,1,22,1767.0294599999995,10,6,8,24,9
TS-11085,2014-10-05,87,8,249.11999999999998,4,4,4,12,4
TS-11160,2014-09-17,105,5,194.67000000000002,3,2,4,9,2
TS-11205,2014-02-27,307,3,-0.8939999999999939,1,1,2,4,1
TS-11340,2014-11-21,40,5,225.846,6,2,4,12,4
TS-11370,2014-12-13,18,10,992.8140000000001,8,5,7,20,7
TS-11430,2014-04-09,266,7,1811.9699999999998,1,3,8,12,4
TS-11505,2014-03-19,287,4,-157.49400000000006,1,1,2,4,1
TS-11610,2014-09-07,115,5,105.41999999999999,3,2,3,8,2
TS-11655,2014-12-06,25,6,73.16999999999999,7,2,3,12,4
TS-21085,2014-12-11,20,19,860.4408,7,6,6,19,6
TS-21160,2014-12-23,8,22,939.3524,9,6,6,21,7
TS-21205,2014-10-29,63,32,2350.4426199999984,4,10,9,23,8
TS-21340,2014-12-23,8,31,2377.118580000001,9,10,9,28,10
TS-21370,2014-12-07,24,27,4101.1514,7,8,10,25,9
TS-21430,2014-12-12,19,22,553.0183000000002,7,6,5,18,6
TS-21505,2014-12-20,11,27,2306.8401999999987,9,8,9,26,9
TS-21610,2014-11-12,49,30,1614.1478999999988,5,9,8,22,8
TS-21655,2014-10-01,91,24,952.4495000000001,3,7,6,16,5
TT-11070,2014-11-24,37,2,621.96,6,1,6,13,4
TT-11220,2014-12-26,5,9,472.3800000000001,10,5,5,20,7
TT-11265,2014-11-09,52,9,1269.7920000000001,5,5,7,17,5
TT-11460,2014-11-19,42,8,-160.14600000000002,5,4,2,11,3
TT-21070,2014-12-17,14,31,1698.3986000000007,8,10,8,26,9
TT-21220,2014-12-03,28,22,1188.8272600000005,6,6,7,19,6
TT-21265,2014-12-30,1,20,15.044199999999993,10,6,2,18,6
TT-21460,2014-12-19,12,32,2390.9353600000004,8,10,9,27,10
TW-11025,2014-12-12,19,8,-137.871,7,4,2,13,4
TW-21025,2014-11-20,41,27,3412.9511000000007,5,8,10,23,8
TZ-11445,2013-12-28,368,7,250.76999999999995,1,3,4,8,2
TZ-11580,2014-11-13,48,5,-275.076,5,2,1,8,2
TZ-21445,2014-12-23,8,28,116.72140000000005,9,9,3,21,7
TZ-21580,2014-11-26,35,19,194.9604999999997,6,6,4,16,5
VB-11745,2014-12-27,4,4,190.82999999999998,10,1,4,15,5
VB-21745,2014-12-19,12,21,717.7338,8,6,6,20,7
VD-11670,2014-12-31,0,9,-211.74900000000002,10,5,2,17,5
VD-21670,2014-11-25,36,21,2243.6648000000005,6,6,9,21,7
VF-11715,2014-09-28,94,4,4.721999999999992,3,1,2,6,1
VF-21715,2014-12-18,13,24,21.390999999999927,8,7,2,17,5
VG-11790,2014-07-24,160,4,47.441999999999986,2,1,3,6,1
VG-11805,2014-08-18,135,4,140.31,2,1,3,6,1
VG-21790,2014-12-09,22,27,-411.8667,7,8,1,16,5
VG-21805,2014-12-29,2,23,3906.5961600000005,10,7,10,27,10
VM-11685,2014-12-18,13,6,-94.96199999999995,8,2,2,12,4
VM-11835,2014-12-23,8,3,338.06999999999994,9,1,4,14,4
VM-21685,2014-11-29,32,32,-1550.8367800000005,6,10,1,17,5
VM-21835,2014-11-09,52,20,318.84429999999986,5,6,4,15,5
VP-11730,2014-07-22,162,4,-508.4100000000001,2,1,1,4,1
VP-11760,2014-09-05,117,3,374.712,3,1,5,9,2
VP-21730,2014-11-21,40,29,2741.2058000000006,6,9,10,25,9
VP-21760,2014-10-17,75,28,2016.1506999999995,4,9,9,22,8
VS-11820,2014-09-12,110,7,126.534,3,3,3,9,2
VS-21820,2014-10-05,87,15,1460.0846999999997,4,6,8,18,6
VT-11700,2014-08-28,125,7,178.57200000000006,3,3,4,10,3
VT-21700,2014-12-24,7,25,912.2112000000003,9,7,6,22,8
VW-11775,2014-12-24,7,5,252.486,9,2,4,15,5
VW-21775,2014-12-25,6,30,41.89489999999992,9,9,3,21,7
WB-11850,2014-08-09,144,2,-146.59799999999998,2,1,2,5,1
WB-21850,2014-12-11,20,38,2694.5003,7,10,10,27,10
XP-11865,2014-07-24,160,3,65.14800000000001,2,1,3,6,1
XP-21865,2014-11-18,43,27,1239.5745999999992,5,8,7,20,7
YC-11895,2014-09-23,99,4,22.269,3,1,2,6,1
YC-21895,2014-12-27,4,27,4324.9076000000005,10,8,10,28,10
YS-11880,2014-12-27,4,6,358.81199999999995,10,2,5,17,5
YS-21880,2014-12-22,9,26,3091.594300000001,9,8,10,27,10
ZC-11910,2014-06-14,200,1,-15.567,2,1,2,5,1
ZC-21910,2014-12-28,3,37,452.5032599999996,10,10,5,25,9
ZD-11925,2014-12-28,3,9,478.41600000000005,10,5,5,20,7
ZD-21925,2014-12-30,1,20,-276.67890000000017,10,6,1,17,5
